阿姨	阿姨	āyí	/maternal aunt/
哎	哎	āi	/hey!/
唉	唉	āi	/interjection or grunt of agreement or recognition (e.g. yes, it's me!)/
愛情	愛情	àiqíng	/romance/
愛惜	愛惜	àixí	/to cherish/
愛心	愛心	àixīn	/compassion/
安定	安定	āndìng	/stable/
安排	安排	ānpái	/to arrange/
安心	安心	ānxīn	/at ease/
按	按	àn	/to press/
按照	按照	ànzhào	/according to/
巴士	巴士	bāshì	/bus (loanword)/
把握	把握	bǎwò	/to grasp (also fig.)/
白菜	白菜	báicài	/Chinese cabbage/
白天	白天	báitian	/daytime/
擺	擺	bǎi	/to arrange/
百貨公司	百貨公司	bǎihuògōngsī	/department store/
班機	班機	bānjī	/airliner/
搬家	搬家	bānjiā	/to move house/
辦理	辦理	bànlǐ	/to handle/
半天	半天	bàntiān	/half of the day/
半夜	半夜	bànyè	/midnight/
幫助	幫助	bāngzhù	/assistance/
榜樣	榜樣	bǎngyàng	/example/
包含	包含	bāohán	/to contain/
寶貝	寶貝	bǎobèi	/treasured object/
寶貴	寶貴	bǎoguì	/valuable/
保護	保護	bǎohù	/to protect/
保守	保守	bǎoshǒu	/conservative/
保養	保養	bǎoyǎng	/to take good care of (or conserve) one's health/
保證	保證	bǎozhèng	/guarantee/
抱	抱	bào	/to hold/
抱怨	抱怨	bàoyuàn	/to complain/
報名	報名	bàomíng	/to sign up/
背包	背包	bēibāo	/knapsack/
北方	北方	běifāng	/north/
被動	被動	bèidòng	/passive/
背後	背後	bèihòu	/behind/
背景	背景	bèijǐng	/background/
輩子	輩子	bèizi	/all one's life/
本人	本人	běnrén	/the person himself/
本子	本子	běnzi	/book/
笨	笨	bèn	/stupid/
逼	逼	bī	/to compel/
比如	比如	bǐrú	/for example/
畢竟	畢竟	bìjìng	/after all/
避免	避免	bìmiǎn	/to avert/
必要	必要	bìyào	/necessary/
鞭炮	鞭炮	biānpào	/firecrackers/
變成	變成	biànchéng	/to change into/
變更	變更	biàngēng	/to change/
變化	變化	biànhuà	/change/
便條	便條	biàntiáo	/(informal) note/
標準	標準	biāozhǔn	/(an official) standard/
表達	表達	biǎodá	/to express/
表面	表面	biǎomiàn	/surface/
表示	表示	biǎoshì	/to express/
表現	表現	biǎoxiàn	/to show/
別的	別的	biéde	/else/
冰塊	冰塊	bīngkuài	/ice cube/
伯伯	伯伯	bóbo	/father's elder brother/
博士	博士	bóshì	/doctor/
播	播	bò	/to sow/
不必	不必	bùbì	/need not/
不斷	不斷	bùduàn	/unceasing/
不過	不過	bùguò	/only/
不見	不見	bùjiàn	/not to see/
不論	不論	bùlùn	/whatever/
不幸	不幸	bùxìng	/misfortune/
不用說	不用說	bùyòngshuō	//
不得不	不得不	bùdébù	/have no choice or option but to/
不得了	不得了	bùdéliǎo	/desperately serious/
不管	不管	bùguǎn	/not to be concerned/
不滿	不滿	bùmǎn	/resentful/
不如	不如	bùrú	/not equal to/
不少	不少	bùshǎo	/many/
不足	不足	bùzú	/insufficient/
部分	部分	bùfen	/part/
部門	部門	bùmén	/department/
布	布	bù	/to announce/
擦	擦	cā	/to wipe/
猜	猜	cāi	/to guess/
材料	材料	cáiliào	/material/
採用	採用	cǎiyòng	/to adopt/
餐桌	餐桌	cānzhuō	/dining table/
參考	參考	cānkǎo	/consultation/
草地	草地	cǎodì	/lawn/
草原	草原	cǎoyuán	/grassland/
層	層	céng	/layer/
曾	曾	céng	/once/
曾經	曾經	céngjīng	/once/
差別	差別	chābié	/difference/
差異	差異	chāyì	/difference/
差點兒	差點兒	chàdiǎnr	/erhua variant of 差點|差点[cha4 dian3]/
產品	產品	chǎnpǐn	/goods/
產生	產生	chǎnshēng	/to arise/
嘗	嘗	chángshì	/to taste/
超過	超過	chāoguò	/to surpass/
超級	超級	chāojí	/super-/
炒	炒	chǎo	/to sauté/
吵架	吵架	chǎojià	/to quarrel/
車禍	車禍	chēhuò	/traffic accident/
趁	趁	chèn	/old variant of 趁[chen4]/
成果	成果	chéngguǒ	/result/
成就	成就	chéngjiù	/accomplishment/
成熟	成熟	chéngshóu	/mature/
成長	成長	chéngzhǎng	/to mature/
程度	程度	chéngdù	/degree (level or extent)/
承認	承認	chéngrèn	/to admit/
誠實	誠實	chéngshí	/honest/
吃喝玩樂	吃喝玩樂	chīhēwánlè	/to eat, drink and be merry (idiom)/
充實	充實	chōngshí	/rich/
重新	重新	chóngxīn	/again/
蟲	蟲	chóng	/lower form of animal life, including insects, insect larvae, worms and similar creatures/
抽	抽	chōu	/to draw out/
醜	醜	chǒu	/shameful/
臭	臭	chòu	/stench/
初	初	chū	/at first/
出版	出版	chūbǎn	/to publish/
出差	出差	chūchāi	/to go on an official or business trip/
出門	出門	chūmén	/to go out/
出租	出租	chūzū	/to rent/
除了	除了	chúle	/besides/
除夕	除夕	chúxì	/lunar New Year's Eve/
廚師	廚師	chúshī	/cook/
處理	處理	chǔlǐ	/to handle/
傳統	傳統	chuántǒng	/tradition/
串	串	chuàn	/to string together/
創造	創造	chuàngzào	/to create/
吹	吹	chuī	/to blow/
春節	春節	chūnjié	/Spring Festival (Chinese New Year)/
詞	詞	cí	/word/
此	此	cǐ	/this/
刺激	刺激	cìjī	/to provoke/
從不	從不	cóngbù	/never/
從來	從來	cónglái	/always/
從小	從小	cóngxiǎo	/from childhood/
醋	醋	cù	/vinegar/
存	存	cún	/to exist/
存在	存在	cúnzài	/to exist/
寸	寸	cùn	/a unit of length/
錯誤	錯誤	cuòwù	/error/
挫折	挫折	cuòzhé	/setback/
答應	答應	dāyìng	/to answer/
達成	達成	dáchéng	/to reach (an agreement)/
打工	打工	dǎgōng	/to work a temporary or casual job/
打架	打架	dǎjià	/to fight/
打聽	打聽	dǎtīng	/to ask about/
打仗	打仗	dǎzhàng	/to fight a battle/
打折	打折	dǎzhé	/to give a discount/
大大	大大	dàdà	/greatly/
大多數	大多數	dàduōshù	/(great) majority/
大方	大方	dàfāng	/expert/
大概	大概	dàgài	/roughly/
大會	大會	dàhuì	/general assembly/
大陸	大陸	dàlù	/mainland China (reference to the PRC)/
大門	大門	dàmén	/entrance/
大小	大小	dàxiǎo	/dimension/
大約	大約	dàyuē	/approximately/
代表	代表	dàibiǎo	/representative/
代替	代替	dàitì	/to replace/
帶來	帶來	dàilái	/to bring/
帶領	帶領	dàilǐng	/to guide/
單純	單純	dānchún	/simple/
單身	單身	dānshēn	/unmarried/
擔任	擔任	dānrèn	/to hold a governmental office or post/
淡	淡	dàn	/insipid/
當場	當場	dāngchǎng	/at the scene/
當地	當地	dāngdì	/local/
當面	當面	dāngmiàn	/to sb's face/
當年	當年	dāngnián	/in those days/
當天	當天	dàngtiān	/on that day/
當中	當中	dāngzhōng	/among/
當作	當作	dàngzuò	/to treat as/
當做	當做	dàngzuò	/to treat as/
倒	倒	dǎo	/to fall/
島	島	dǎo	/island/
導演	導演	dǎoyǎn	/to direct/
到處	到處	dàochù	/everywhere/
到底	到底	dàodǐ	/finally/
道德	道德	dàodé	/virtue/
道教	道教	dàojiào	/Taoism/
道理	道理	dàolǐ	/reason/
道歉	道歉	dàoqiàn	/to apologize/
倒是	倒是	dàoshì	/contrary to what one might expect/
得到	得到	dédào	/to get/
得意	得意	déyì	/proud of oneself/
得很	得很	dehěn	/(after an adjective) very/
的話	的話	dehuà	/if (coming after a conditional clause)/
燈光	燈光	dēngguāng	/(stage) lighting/
等待	等待	děngdài	/to wait/
低	低	dī	/low/
敵人	敵人	dírén	/enemy/
底下	底下	dǐxia	/the location below sth/
抵達	抵達	dǐdá	/to arrive/
地板	地板	dìbǎn	/floor/
地帶	地帶	dìdài	/zone/
地點	地點	dìdiǎn	/place/
地理	地理	dìlǐ	/geography/
地區	地區	dìqū	/local/
地攤	地攤	dìtān	/street stall with goods laid out on the ground/
地位	地位	dìwèi	/position/
地下	地下	dìxià	/underground/
地形	地形	dìxíng	/topography/
電車	電車	diànchē	/trolleybus/
電池	電池	diànchí	/battery/
電燈	電燈	diàndēng	/electric light/
店員	店員	diànyuán	/shop assistant/
調查	調查	diàochá	/investigation/
訂	訂	dìng	/to agree/
東北	東北	dōngběi	/Northeast China/
東方	東方	dōngfāng	/the East/
東南	東南	dōngnán	/southeast/
懂事	懂事	dǒngshì	/sensible/
逗	逗	dòu	/to stay/
豆腐	豆腐	dòufu	/tofu/
豆漿	豆漿	dòujiāng	/soy milk/
都市	都市	dūshì	/city/
毒品	毒品	dúpǐn	/drugs/
獨特	獨特	dútè	/unique/
讀者	讀者	dúzhě	/reader/
段	段	duàn	/paragraph/
堆	堆	duī	/to pile up/
對方	對方	duìfāng	/counterpart/
對話	對話	duìhuà	/dialogue/
對了	對了	duìle	/Correct!/
對象	對象	duìxiàng	/target/
多多少少	多多少少	duōduoshǎoshǎo	/to some extent/
多麼	多麼	duōme	/how (wonderful etc)/
頓	頓	dùn	/to stop/
嗯	嗯	en	/(a groaning sound)/
兒童	兒童	értóng	/child/
發表	發表	fābiǎo	/to issue/
發財	發財	fācái	/to get rich/
發出	發出	fāchū	/to issue (an order, decree etc)/
發達	發達	fādá	/developed (country etc)/
發揮	發揮	fāhuī	/to display/
發覺	發覺	fājué	/to become aware/
發明	發明	fāmíng	/to invent/
發脾氣	發脾氣	fāpíqi	/to get angry/
發票	發票	fāpiào	/invoice/
法律	法律	fǎlǜ	/law/
翻	翻	fān	/variant of 翻[fan1]/
翻譯	翻譯	fānyì	/to translate/
煩惱	煩惱	fánnǎo	/to be worried/
反而	反而	fǎnér	/instead/
反應	反應	fǎnyìng	/to react/
犯	犯	fàn	/to violate/
範圍	範圍	fànwéi	/range/
方面	方面	fāngmiàn	/respect/
方式	方式	fāngshì	/way/
房東	房東	fángdōng	/landlord/
房客	房客	fángkè	/tenant/
房屋	房屋	fángwū	/house/
訪問	訪問	fǎngwèn	/to visit/
放心	放心	fàngxīn	/to feel relieved/
費用	費用	fèiyòng	/cost/
分開	分開	fēnkāi	/to separate/
份	份	fèn	/classifier for gifts, newspaper, magazine, papers, reports, contracts etc/
豐富	豐富	fēngfù	/to enrich/
風格	風格	fēnggé	/style/
風俗	風俗	fēngsú	/social custom/
佛教	佛教	fójiào	/Buddhism/
否則	否則	fǒuzé	/if not/
夫婦	夫婦	fūfù	/a (married) couple/
符合	符合	fúhé	/in keeping with/
福利	福利	fúlì	/material benefit/
服裝	服裝	fúzhuāng	/dress/
腐敗	腐敗	fǔbài	/corruption/
付出	付出	fùchū	/to pay/
負擔	負擔	fùdān	/burden/
負責	負責	fùzé	/to be in charge of/
複習	複習	fùxí	/variant of 復習|复习[fu4 xi2]/
改	改	gǎi	/to change/
改變	改變	gǎibiàn	/to change/
改進	改進	gǎijìn	/to improve/
改善	改善	gǎishàn	/to make better/
改天	改天	gǎitiān	/another day/
蓋	蓋	gài	/lid/
概念	概念	gàiniàn	/concept/
趕	趕	gǎn	/to overtake/
趕快	趕快	gǎnkuài	/at once/
趕上	趕上	gǎnshàng	/to keep up with/
感動	感動	gǎndòng	/to move (sb)/
感想	感想	gǎnxiǎng	/impressions/
感興趣	感興趣	gǎnxìngqù	/to be interested/
高速	高速	gāosù	/high speed/
高中	高中	gāozhōng	/senior high school/
搞	搞	gǎo	/to do/
歌曲	歌曲	gēqǔ	/song/
歌星	歌星	gēxīng	/singing star/
隔壁	隔壁	gébì	/next door/
革命	革命	gémìng	/revolution/
個人	個人	gèrén	/individual/
個子	個子	gèzi	/height/
各式各樣	各式各樣	gèshìgèyàng	/(of) all kinds and sorts/
各位	各位	gèwèi	/everybody/
根	根	gēn	/root/
根據	根據	gēnjù	/according to/
更加	更加	gèngjiā	/more (than sth else)/
公尺	公尺	gōngchǐ	/meter (unit of length)/
公分	公分	gōngfēn	/centimeter/
公共	公共	gōnggòng	/public/
公克	公克	gōngkè	/gram/
公路	公路	gōnglù	/highway/
功夫	功夫	gōngfu	/skill/
功能	功能	gōngnéng	/function/
工具	工具	gōngjù	/tool/
工業	工業	gōngyè	/industry/
恭喜	恭喜	gōngxǐ	/congratulations/
共同	共同	gòngtóng	/common/
貢獻	貢獻	gòngxiàn	/to contribute/
溝通	溝通	gōutōng	/to join/
購買	購買	gòumǎi	/to purchase/
姑娘	姑娘	gūniáng	/girl/
古	古	gǔ	/ancient/
古代	古代	gǔdài	/ancient times/
古蹟	古蹟	gǔjī	//
古老	古老	gǔlǎo	/ancient/
故意	故意	gùyì	/deliberately/
刮	刮	guā	/to blow (of the wind)/
乖	乖	guāi	/(of a child) obedient, well-behaved/
觀察	觀察	guānchá	/to observe/
觀點	觀點	guāndiǎn	/point of view/
觀念	觀念	guānniàn	/notion/
觀眾	觀眾	guānzhòng	/spectators/
罐	罐	guàn	/variant of 罐[guan4]/
廣播	廣播	guǎngbò	/broadcast/
廣場	廣場	guǎngchǎng	/public square/
廣告	廣告	guǎnggào	/to advertise/
逛	逛	guàng	/to stroll/
逛街	逛街	guàngjiē	/to take a walk/
規矩	規矩	guījǔ	/lit. compass and set square/
規模	規模	guīmó	/scale/
鬼	鬼	guǐ	/ghost/
貴姓	貴姓	guìxìng	/what is your surname?/
櫃子	櫃子	guìzi	/cupboard/
國內	國內	guónèi	/domestic/
國外	國外	guówài	/abroad/
國王	國王	guówáng	/king/
國語	國語	guóyǔ	/Chinese language (Mandarin), emphasizing its national nature/
過日子	過日子	guòrìzi	/to live one's life/
嗨	嗨	hāi	/oh alas/
還好	還好	háihǎo	/not bad/
還要	還要	háiyào	//
海報	海報	hǎibào	/poster/
海灘	海灘	hǎitān	/beach/
海洋	海洋	hǎiyáng	/ocean/
害怕	害怕	hàipà	/to be afraid/
航空	航空	hángkōng	/aviation/
好處	好處	hǎochù	/benefit/
好好	好好	hǎohǎo	/well/
好幾	好幾	hǎojǐ	/several/
好了	好了	hǎole	//
好些	好些	hǎoxiē	/a good deal of/
合唱	合唱	héchàng	/chorus/
合作	合作	hézuò	/to cooperate/
恨	恨	hèn	/to hate/
恨不得	恨不得	hènbude	/wishing one could do sth/
紅包	紅包	hóngbāo	/money wrapped in red as a gift/
紅豆	紅豆	hóngdòu	/azuki bean/
厚	厚	hòu	/thick/
忽然	忽然	hūrán	/suddenly/
糊塗	糊塗	hútú	/muddled/
互相	互相	hùxiāng	/each other/
花心	花心	huāxīn	/fickle (in love affairs)/
滑雪	滑雪	huáxuě	/to ski/
畫家	畫家	huàjiā	/painter/
話說回來	話說回來	huàshuōhuílái	/returning to our main topic,.../
話題	話題	huàtí	/subject (of a talk or conversation)/
化妝品	化妝品	huàzhuāngpǐn	/cosmetic/
壞處	壞處	huàichù	/harm/
環保	環保	huánbǎo	/environmental protection/
回想	回想	huíxiǎng	/to recall/
會場	會場	huìchǎng	/meeting place/
會話	會話	huìhuà	/conversation/
會議	會議	huìyì	/meeting/
婚禮	婚禮	hūnlǐ	/wedding ceremony/
婚姻	婚姻	hūnyīn	/matrimony/
混亂	混亂	hùnluàn	/confusion/
或許	或許	huòxǔ	/perhaps/
基本	基本	jīběn	/basic/
基礎	基礎	jīchǔ	/base/
基督教	基督教	jīdūjiào	/Christianity/
激動	激動	jīdòng	/to move emotionally/
激烈	激烈	jīliè	/intense/
積極	積極	jījí	/active/
機器	機器	jīqì	/machine/
及	及	jí	/and/
極了	極了	jíle	/extremely/
擠	擠	jǐ	/to crowd in/
既	既	jì	/already/
記錄	記錄	jìlù	/to record/
記憶	記憶	jìyì	/to remember/
季節	季節	jìjié	/time/
紀念	紀念	jìniàn	/to commemorate/
技巧	技巧	jìqiǎo	/skill/
繼續	繼續	jìxù	/to continue/
加強	加強	jiāqiáng	/to reinforce/
加入	加入	jiārù	/to become a member/
加上	加上	jiāshàng	/plus/
加油	加油	jiāyóu	/to add oil/
家鄉	家鄉	jiāxiāng	/hometown/
家長	家長	jiāzhǎng	/head of a household/
假如	假如	jiǎrú	/if/
假裝	假裝	jiǎzhuāng	/to feign/
假日	假日	jiàrì	/holiday/
價值	價值	jiàzhí	/value/
肩膀	肩膀	jiānbǎng	/shoulder/
堅持	堅持	jiānchí	/to persevere with/
堅強	堅強	jiānqiáng	/staunch/
減	減	jiǎn	/to lower/
減輕	減輕	jiǎnqīng	/to lighten/
減少	減少	jiǎnshǎo	/to lessen/
簡直	簡直	jiǎnzhí	/simply/
建立	建立	jiànlì	/to establish/
建設	建設	jiànshè	/to build/
建議	建議	jiànyì	/to propose/
將來	將來	jiānglái	/in the future/
講價	講價	jiǎngjià	/to bargain (over price)/
講究	講究	jiǎngjiu	/to pay particular attention to/
獎學金	獎學金	jiǎngxuéjīn	/scholarship/
降低	降低	jiàngdī	/to reduce/
醬油	醬油	jiàngyóu	/soy sauce/
交流	交流	jiāoliú	/to exchange/
交友	交友	jiāoyǒu	/to make friends/
驕傲	驕傲	jiāoào	/pride/
郊區	郊區	jiāoqū	/suburban district/
角度	角度	jiǎodù	/angle/
角色	角色	jiǎo	/role/
教材	教材	jiàocái	/teaching material/
教導	教導	jiàodǎo	/to instruct/
教法	教法	jiàofǎ	/teaching method/
教練	教練	jiàoliàn	/instructor/
教授	教授	jiàoshòu	/professor/
教訓	教訓	jiàoxun	/lesson/
教育	教育	jiàoyù	/to educate/
接觸	接觸	jiēchù	/to touch/
接受	接受	jiēshòu	/to accept/
接著	接著	jiēzhe	/to catch and hold on/
結果	結果	jiéguǒ	/to bear fruit/
結局	結局	jiéjú	/conclusion/
節日	節日	jiérì	/holiday/
解決	解決	jiějué	/to settle (a dispute)/
姊妹	姊妹	jiěmèi	/(older and younger) sisters/
僅	僅	jǐn	/barely/
儘管	儘管	jǐnguǎn	/despite/
盡	盡	jìn	/to use up/
進行	進行	jìnxíng	/to advance/
進一步	進一步	jìnyíbù	/one step further/
經費	經費	jīngfèi	/funds/
精神	精神	jīngshén	/spirit/
驚訝	驚訝	jīngyà	/amazed/
酒吧	酒吧	jiǔbā	/bar/
舅舅	舅舅	jiùjiu	/mother's brother/
舅媽	舅媽	jiùmā	/(coll.) aunt/
就是	就是	jiùshì	/(emphasizes that sth is precisely or exactly as stated)/
就算	就算	jiùsuàn	/granted that/
就要	就要	jiùyào	/will/
居住	居住	jūzhù	/to reside/
橘子	橘子	júzi	/tangerine/
舉	舉	jǔ	/to lift/
舉辦	舉辦	jǔbàn	/to conduct/
舉手	舉手	jǔshǒu	/to raise a hand/
舉行	舉行	jǔxíng	/to hold (a meeting, ceremony etc)/
聚	聚	jù	/to congregate/
劇本	劇本	jùběn	/script for play, opera, movie etc/
劇情	劇情	jùqíng	/story line/
拒絕	拒絕	jùjué	/to refuse/
距離	距離	jùlí	/distance/
具有	具有	jùyǒu	/to have/
絕對	絕對	juéduì	/absolute/
軍隊	軍隊	jūnduì	/army/
軍人	軍人	jūnrén	/serviceman/
卡車	卡車	kǎchē	/truck/
開放	開放	kāifàng	/to bloom/
開花	開花	kāihuā	/to bloom/
開朗	開朗	kāilǎng	/spacious and well-lit/
開玩笑	開玩笑	kāiwánxiào	/to play a joke/
看不起	看不起	kànbuqǐ	/to look down upon/
看法	看法	kànfǎ	/way of looking at a thing/
看起來	看起來	kànqǐlái	/seemingly/
棵	棵	kē	/classifier for trees, cabbages, plants etc/
刻	刻	kè	/quarter (hour)/
科技	科技	kējì	/science and technology/
可靠	可靠	kěkào	/reliable/
可樂	可樂	kělè	/amusing/
可惡	可惡	kěwù	/repulsive/
可惜	可惜	kěxí	/it is a pity/
渴望	渴望	kěwàng	/to thirst for/
克服	克服	kèfú	/(try to) overcome (hardships etc)/
課程	課程	kèchéng	/course/
課堂	課堂	kètáng	/classroom/
課文	課文	kèwén	/text/
客滿	客滿	kèmǎn	/to have a full house/
肯	肯	kěn	/to agree/
肯定	肯定	kěndìng	/to be certain/
空間	空間	kōngjiān	/space/
空軍	空軍	kōngjūn	/air force/
恐怕	恐怕	kǒngpà	/fear/
口袋	口袋	kǒudài	/pocket/
口味	口味	kǒuwèi	/a person's preferences/
誇張	誇張	kuāzhāng	/to exaggerate/
快要	快要	kuàiyào	/almost/
寬	寬	kuān	/lenient/
況且	況且	kuàngqiě	/moreover/
困難	困難	kùnnán	/difficult/
擴大	擴大	kuòdà	/to expand/
拉肚子	拉肚子	lādùzi	/(coll.) to have diarrhea/
啦	啦	la	/(onom.) sound of singing, cheering etc/
來不及	來不及	láibùjí	/there's not enough time (to do sth)/
來得及	來得及	láidejí	/there's still time/
浪漫	浪漫	làngmàn	/romantic/
老公	老公	lǎogōng	/(coll.) husband/
老虎	老虎	lǎohǔ	/tiger/
老婆	老婆	lǎopo	/(coll.) wife/
老實	老實	lǎoshi	/honest/
老是	老是	lǎoshì	/always/
樂觀	樂觀	lèguān	/optimistic/
樂趣	樂趣	lèqù	/delight/
垃圾	垃圾	lèsè	/trash/
淚	淚	lèi	/tears/
類	類	lèi	/kind/
冷淡	冷淡	lěngdàn	/cold/
離婚	離婚	líhūn	/to divorce/
裡邊	裡邊	lǐbiān	/inside/
理解	理解	lǐjiě	/to comprehend/
理論	理論	lǐlùn	/theory/
理想	理想	lǐxiǎng	/an ideal/
裏面	裏面	lǐmiàn	//
禮堂	禮堂	lǐtáng	/assembly hall/
力量	力量	lìlìang	/power/
厲害	厲害	lìhai	/difficult to deal with/
立刻	立刻	lìkè	/forthwith/
例如	例如	lìrú	/for example/
例子	例子	lìzi	/case/
利益	利益	lìyì	/benefit/
利用	利用	lìyòng	/to exploit/
連	連	lián	/to link/
連續劇	連續劇	liánxùjù	/serialized drama/
戀愛	戀愛	liànài	/(romantic) love/
良好	良好	liánghǎo	/good/
了不起	了不起	liǎobuqǐ	/amazing/
靈魂	靈魂	línghún	/soul/
零錢	零錢	língqián	/change (of money)/
零用錢	零用錢	língyòngqián	/pocket money/
領導	領導	lǐngdǎo	/lead/
領域	領域	lǐngyù	/domain/
令	令	lìng	/classifier for a ream of paper/
流汗	流汗	liúhàn	/to sweat/
流血	流血	liúxiě	/to bleed/
留學	留學	liúxué	/to study abroad/
留學生	留學生	liúxuéshēng	/student studying abroad/
龍	龍	lóng	/dragon/
錄取	錄取	lùqǔ	/to accept an applicant (prospective student, employee etc) who passes an entrance exam/
錄音	錄音	lùyīn	/to record (sound)/
露營	露營	lùyíng	/to camp out/
輪胎	輪胎	lúntāi	/tire/
旅客	旅客	lǚkè	/traveler/
律師	律師	lǜshī	/lawyer/
馬桶	馬桶	mǎtǒng	/chamber pot/
碼頭	碼頭	mǎtou	/dock/
螞蟻	螞蟻	mǎyǐ	/ant/
罵	罵	mà	/to scold/
嘛	嘛	ma	/modal particle indicating that sth is obvious/
滿足	滿足	mǎnzú	/to satisfy/
慢慢	慢慢	mànmàn	/slowly/
慢跑	慢跑	mànpǎo	/jogging/
慢用	慢用	mànyòng	/same as 慢慢吃[man4 man4 chi1]/
毛病	毛病	máobìng	/fault/
貿易	貿易	màoyì	/(commercial) trade/
沒什麼	沒什麼	méishénme	/nothing/
沒想到	沒想到	méixiǎngdào	/didn't expect/
玫瑰	玫瑰	méigui	/rugosa rose (shrub) (Rosa rugosa)/
美好	美好	měihǎo	/beautiful/
夢	夢	mèng	/dream/
迷路	迷路	mílù	/to lose the way/
迷人	迷人	mírén	/fascinating/
米飯	米飯	mǐfàn	/(cooked) rice/
米粉	米粉	mǐfěn	/rice flour/
秘	秘	mìmì	/secret/
密切	密切	mìqiè	/close/
免費	免費	miǎnfèi	/free (of charge)/
面積	面積	miànjī	/area (of a floor, piece of land etc)/
面前	面前	miànqián	/in front of/
麵條	麵條	miàntiáo	/noodles/
描寫	描寫	miáoxiě	/to describe/
秒	秒	miǎo	/second (unit of time)/
廟	廟	miào	/temple/
民國	民國	mínguó	/Republic of China (1912-1949)/
民族	民族	mínzú	/nationality/
名詞	名詞	míngcí	/noun/
明白	明白	míngbái	/clear/
明顯	明顯	míngxiǎn	/clear/
明星	明星	míngxīng	/star/
摸	摸	mō	/to feel with the hand/
摩托車	摩托車	mótuōchē	/motorbike/
陌生	陌生	mòshēng	/strange/
某	某	mǒu	/some/
木	木	mù	/tree/
木頭	木頭	mùtou	/slow-witted/
目的	目的	mùdì	/purpose/
目前	目前	mùqián	/at the present time/
拿手	拿手	náshǒu	/expert in/
哪些	哪些	nǎxiē	/which ones?/
那樣	那樣	nàyàng	/that kind/
奶茶	奶茶	nǎichá	/milk tea/
耐心	耐心	nàixīn	/to be patient/
南方	南方	nánfāng	/south/
難怪	難怪	nánguài	/(it's) no wonder (that...)/
難看	難看	nánkàn	/ugly/
腦子	腦子	nǎozi	/brains/
鬧鐘	鬧鐘	nàozhōng	/alarm clock/
內容	內容	nèiróng	/content/
能夠	能夠	nénggòu	/to be capable of/
能力	能力	nénglì	/capability/
年代	年代	niándài	/a decade of a century (e.g. the Sixties)/
年齡	年齡	niánlíng	/(a person's) age/
年年	年年	niánnián	/year after year/
念書	念書	niànshū	/to read/
農業	農業	nóngyè	/agriculture/
女士	女士	nǚshì	/lady/
喔	喔	ō	/I see/
哦	哦	ó	/to chant/
噢	噢	yǔ	/Oh!/
拍	拍	pāi	/to pat/
牌子	牌子	páizi	/sign/
盼望	盼望	pànwàng	/to hope for/
陪	陪	péi	/to accompany/
培養	培養	péiyǎng	/to cultivate/
配	配	pèi	/to join/
配合	配合	pèihé	/matching/
碰	碰	pèng	/old variant of 碰[peng4]/
碰到	碰到	pèngdào	/to come across/
碰上	碰上	pèngshàng	/to run into/
批評	批評	pīpíng	/to criticize/
皮帶	皮帶	pídài	/strap/
皮膚	皮膚	pífū	/skin/
皮鞋	皮鞋	píxié	/leather shoes/
篇	篇	piān	/sheet/
騙子	騙子	piànzi	/swindler/
品質	品質	pǐnzhí	/character/
坪	坪	píng	/a plain/
平安	平安	píngān	/safe and sound/
平等	平等	píngděng	/equal/
平時	平時	píngshí	/ordinarily/
平原	平原	píngyuán	/field/
瓶子	瓶子	píngzi	/bottle/
破	破	pò	/broken/
破壞	破壞	pòhuài	/destruction/
葡萄	葡萄	pútao	/grape/
普遍	普遍	pǔbiàn	/universal/
欺負	欺負	qīfù	/to bully/
其次	其次	qícì	/next/
其實	其實	qíshí	/actually/
其中	其中	qízhōng	/among/
期間	期間	qíjiān	/period of time/
氣溫	氣溫	qìwēn	/air temperature/
汽水	汽水	qìshuǐ	/soda/
企業	企業	qìyè	/company/
簽名	簽名	qiānmíng	/to sign (one's name with a pen etc)/
簽證	簽證	qiānzhèng	/visa/
謙虛	謙虛	qiānxū	/modest/
前年	前年	qiánnián	/the year before last/
淺	淺	qiǎn	/sound of moving water/
強盜	強盜	qiángdào	/to rob (with force)/
強調	強調	qiángdiào	/to emphasize (a statement)/
搶	搶	qiǎng	/to fight over/
親切	親切	qīnqiè	/amiable/
親手	親手	qīnshǒu	/personally/
親眼	親眼	qīnyǎn	/with one's own eyes/
親自	親自	qīnzì	/personally/
青年	青年	qīngnián	/youth/
青少年	青少年	qīngshàonián	/adolescent/
輕鬆	輕鬆	qīngsōng	/light/
情人	情人	qíngrén	/lover/
情況	情況	qíngkuàng	/circumstances/
情形	情形	qíngxíng	/circumstances/
請教	請教	qǐngjiào	/to ask for guidance/
請求	請求	qǐngqiú	/to request/
窮	窮	qióng	/poor/
球場	球場	qiúchǎng	/stadium/
球賽	球賽	qiúsài	/sports match/
球員	球員	qiúyuán	/sports club member/
取代	取代	qǔdài	/to replace/
去世	去世	qùshì	/to pass away/
全球	全球	quánqiú	/entire/
全身	全身	quánshēn	/whole body/
缺點	缺點	quēdiǎn	/weak point/
卻	卻	què	/but/
確定	確定	quèdìng	/definite/
確認	確認	quèrèn	/to confirm/
熱狗	熱狗	règǒu	/hot dog (loanword)/
熱水	熱水	rèshuǐ	/hot water/
人家	人家	rénjiā	/household/
人間	人間	rénjiān	/the human world/
人口	人口	rénkǒu	/population/
人類	人類	rénlèi	/humanity/
人們	人們	rénmen	/people/
人民	人民	rénmín	/the people/
人人	人人	rénrén	/everyone/
人數	人數	rénshù	/number of people/
人物	人物	rénwù	/person/
忍	忍	rěn	/to bear/
忍耐	忍耐	rěnnài	/to endure/
認得	認得	rènde	/to recognize/
任務	任務	rènwù	/mission/
扔	扔	rēng	/to throw/
仍	仍	réng	/still/
仍然	仍然	réngrán	/still/
日出	日出	rìchū	/sunrise/
日記	日記	rìjì	/diary/
日子	日子	rìzi	/day/
如此	如此	rúcǐ	/in this way/
如下	如下	rúxià	/as follows/
如意	如意	rúyì	/as one wants/
弱	弱	ruò	/weak/
傘	傘	sǎn	/umbrella/
殺	殺	shā	/to kill/
晒	晒	shài	/(of the sun) to shine on/
山區	山區	shānqū	/mountain area/
傷害	傷害	shānghài	/to injure/
商品	商品	shāngpǐn	/commodity/
商人	商人	shāngrén	/merchant/
商業	商業	shāngyè	/business/
上當	上當	shàngdàng	/taken in (by sb's deceit)/
上帝	上帝	shàngdì	/God/
上街	上街	shàngjiē	/to go onto the streets/
上衣	上衣	shàngyī	/jacket/
蛇	蛇	shé	/snake/
設備	設備	shèbèi	/equipment/
設計	設計	shèjì	/plan/
深	深	shēn	/deep/
深入	深入	shēnrù	/to penetrate deeply/
身邊	身邊	shēnbiān	/at one's side/
身高	身高	shēngāo	/(a person's) height/
身上	身上	shēnshàng	/on the body/
甚至	甚至	shènzhì	/even/
升	升	shēng	/variant of 升[sheng1]/
聲調	聲調	shēngdiào	/tone/
生產	生產	shēngchǎn	/to produce/
生動	生動	shēngdòng	/vivid/
生命	生命	shēngmìng	/life (as the characteristic of living beings)/
生意	生意	shēngyì	/life force/
生字	生字	shēngzì	/new character (in textbook)/
省	省	shěng	/to save/
省錢	省錢	shěngqián	/to save money/
剩	剩	shèng	/to remain/
剩下	剩下	shèngxia	/to remain/
濕	濕	shī	/moist/
失戀	失戀	shīliàn	/to lose one's love/
失去	失去	shīqù	/to lose/
獅子	獅子	shīzi	/Leo (star sign)/
十分	十分	shífēn	/very/
石頭	石頭	shítou	/stone/
石油	石油	shíyóu	/oil/
時代	時代	shídài	/Time, US weekly news magazine/
時刻	時刻	shíkè	/time/
實話	實話	shíhuà	/truth/
實際	實際	shíjì	/reality/
實力	實力	shílì	/strength/
實行	實行	shíxíng	/to implement/
實在	實在	shízài	/really/
使得	使得	shǐde	/usable/
使用	使用	shǐyòng	/to use/
事實	事實	shìshí	/fact/
事業	事業	shìyè	/undertaking/
適應	適應	shìyìng	/to adapt/
市長	市長	shìzhǎng	/mayor/
收穫	收穫	shōuhuò	/to harvest/
收音機	收音機	shōuyīnjī	/radio/
首	首	shǒu	/head/
手套	手套	shǒutào	/glove/
手續	手續	shǒuxù	/procedure/
受得了	受得了	shòudeliao	//
書包	書包	shūbāo	/schoolbag/
書架	書架	shūjià	/bookshelf/
蔬菜	蔬菜	shūcài	/vegetables/
舒適	舒適	shūshì	/cozy/
叔叔	叔叔	shúshu	/father's younger brother/
熟悉	熟悉	shoúxī	/to be familiar with/
數字	數字	shùzì	/numeral/
樹木	樹木	shùmù	/tree/
刷牙	刷牙	shuāyá	/to brush one's teeth/
帥	帥	shuài	/handsome/
水餃	水餃	shuǐjiǎo	/boiled dumpling/
水平	水平	shuǐpíng	/level (of achievement etc)/
水準	水準	shuǐzhǔn	/level (of achievement etc)/
睡著	睡著	shuìzháo	/to fall asleep/
順便	順便	shùnbiàn	/conveniently/
順利	順利	shùnlì	/smoothly/
說法	說法	shuōfǎ	/to expound Buddhist teachings/
說明	說明	shuōmíng	/to explain/
說起來	說起來	shuōqilai	//
思考	思考	sīkǎo	/to reflect on/
思想	思想	sīxiǎng	/thought/
似乎	似乎	sìhū	/apparently/
寺廟	寺廟	sìmiào	/temple/
速度	速度	sùdù	/speed/
算了	算了	suànle	/let it be/
隨便	隨便	suíbiàn	/as one wishes/
隨時	隨時	suíshí	/at any time/
所謂	所謂	suǒwèi	/so-called/
它	它	tā	/it/
它們	它們	tāmen	/they (for inanimate objects)/
抬	抬	tái	/to lift/
颱風	颱風	táifēng	/hurricane/
態度	態度	tàidù	/manner/
談話	談話	tánhuà	/talk/
討厭	討厭	tǎoyàn	/to dislike/
特地	特地	tèdì	/specially/
特色	特色	tèsè	/characteristic/
特殊	特殊	tèshū	/special/
提	提	tí	/to carry (hanging down from the hand)/
提到	提到	tídào	/to mention/
提高	提高	tígāo	/to raise/
提供	提供	tígōng	/to offer/
題材	題材	tícái	/subject matter/
題目	題目	tímù	/subject/
體會	體會	tǐhuì	/to know from experience/
體力	體力	tǐlì	/physical strength/
體貼	體貼	tǐtiē	/considerate (of other people's needs)/
體重	體重	tǐzhòng	/body weight/
天堂	天堂	tiāntáng	/paradise/
天天	天天	tiāntiān	/every day/
天下	天下	tiānxià	/land under heaven/
田	田	tián	/field/
填	填	tián	/to fill or stuff/
甜點	甜點	tiándiǎn	/dessert/
條件	條件	tiáojiàn	/condition/
挑戰	挑戰	tiǎozhàn	/to challenge/
鐵路	鐵路	tiělù	/railroad/
聽見	聽見	tīngjiàn	/to hear/
聽力	聽力	tīnglì	/hearing/
聽起來	聽起來	tīngqǐlái	/to sound like/
聽眾	聽眾	tīngzhòng	/audience/
挺	挺	tǐng	/straight/
通過	通過	tōngguò	/by means of/
同情	同情	tóngqíng	/to sympathize with/
同時	同時	tóngshí	/at the same time/
同樣	同樣	tóngyàng	/same/
痛苦	痛苦	tòngkǔ	/pain/
投	投	tóu	/to cast/
投資	投資	tóuzī	/investment/
頭痛	頭痛	tóutòng	/to have a headache/
突然	突然	túrán	/sudden/
土	土	tǔ	/Tu (ethnic group)/
土地	土地	tǔdì	/land/
兔子	兔子	tùzi	/hare/
團體	團體	tuántǐ	/group/
團圓	團圓	tuányuán	/to have a reunion/
推	推	tuī	/to push/
推薦	推薦	tuījiàn	/to recommend/
推銷	推銷	tuīxiāo	/to market/
退步	退步	tuìbù	/to do less well than before/
退休	退休	tuìxiū	/to retire/
脫	脫	tuō	/to shed/
娃娃	娃娃	wáwa	/baby/
外邊	外邊	wàibiān	/outside/
外公	外公	wàigōng	/(coll.) mother's father/
外婆	外婆	wàipó	/(coll.) mother's mother/
外文	外文	wàiwén	/foreign language (written)/
外語	外語	wàiyǔ	/foreign language/
完成	完成	wánchéng	/to complete/
完全	完全	wánquán	/complete/
玩具	玩具	wánjù	/plaything/
萬一	萬一	wànyī	/just in case/
網路	網路	wǎnglù	/network (computer, telecom)/
往往	往往	wǎngwǎng	/usually/
忘記	忘記	wàngjì	/to forget/
維持	維持	wéichí	/to keep/
微笑	微笑	wéixiào	/smile/
為主	為主	wéizhǔ	/to rely mainly on/
偉大	偉大	wěidà	/huge/
未來	未來	wèilái	/future/
位置	位置	wèizhì	/position/
位子	位子	wèizi	/place/
溫柔	溫柔	wēnróu	/gentle and soft/
文件	文件	wénjiàn	/document/
文學	文學	wénxué	/literature/
文字	文字	wénzì	/character/
穩定	穩定	wěndìng	/steady/
問好	問好	wènhǎo	/to say hello to/
問候	問候	wènhòu	/to give one's respects/
握手	握手	wòshǒu	/to shake hands/
屋子	屋子	wūzi	/house/
無法	無法	wúfǎ	/unable/
無論如何	無論如何	wúlùnrúhé	/whatever the case/
無窮	無窮	wúqióng	/endless/
無所謂	無所謂	wúsuǒwèi	/to be indifferent/
誤會	誤會	wùhuì	/to misunderstand/
物價	物價	wùjià	/(commodity) prices/
西北	西北	xīběi	/Northwest China (Shaanxi, Gansu, Qinghai, Ningxia, Xinjiang)/
西餐	西餐	xīcān	/Western-style food/
西方	西方	xīfāng	/the West/
西南	西南	xīnán	/southwest/
吸毒	吸毒	xīdú	/to take drugs/
吸收	吸收	xīshōu	/to absorb/
吸引	吸引	xīyǐn	/to attract (interest, investment etc)/
犧牲	犧牲	xīshēng	/to sacrifice one's life/
喜愛	喜愛	xǐài	/to like/
細	細	xì	/thin or slender/
細心	細心	xìxīn	/careful/
戲	戲	xì	/trick/
戲劇	戲劇	xìjù	/drama/
系統	系統	xìtǒng	/system/
下來	下來	xiàlai	/to come down/
嚇	嚇	xià	/to scare/
嚇一跳	嚇一跳	xiàyítiào	/startled/
線	線	xiàn	/thread/
現代	現代	xiàndài	/Hyundai, South Korean company/
現實	現實	xiànshí	/reality/
現象	現象	xiànxiàng	/appearance/
限制	限制	xiànzhì	/to restrict/
相當	相當	xiāngdāng	/equivalent to/
相對	相對	xiāngduì	/relatively/
相反	相反	xiāngfǎn	/opposite/
相關	相關	xiāngguān	/related/
相同	相同	xiāngtóng	/identical/
箱子	箱子	xiāngzi	/suitcase/
香水	香水	xiāngshuǐ	/perfume/
詳細	詳細	xiángxì	/detailed/
想到	想到	xiǎngdào	/to think of/
想法	想法	xiǎngfǎ	/way of thinking/
想像	想像	xiǎngxiàng	/to imagine/
項	項	xiàng	/back of neck/
相機	相機	xiàngjī	/at the opportune moment/
相聲	相聲	xiàngshēng	/comic dialogue/
小吃	小吃	xiǎochī	/snack/
小朋友	小朋友	xiǎopéngyǒu	/child/
小組	小組	xiǎozǔ	/group/
效果	效果	xiàoguǒ	/result/
笑話	笑話	xiàohuà	/joke/
孝順	孝順	xiàoshùn	/filial piety/
協助	協助	xiézhù	/to provide assistance/
心得	心得	xīndé	/what one has learned (through experience, reading etc)/
心理	心理	xīnlǐ	/mental/
心意	心意	xīnyì	/regard/
欣賞	欣賞	xīnshǎng	/to appreciate/
新生	新生	xīnshēng	/new/
信箱	信箱	xìnxiāng	/mailbox/
信心	信心	xìnxīn	/confidence/
興奮	興奮	xīngfèn	/excited/
行動	行動	xíngdòng	/operation/
行為	行為	xíngwéi	/action/
形容	形容	xíngróng	/to describe/
醒	醒	xǐng	/to wake up/
醒來	醒來	xǐnglái	/to waken/
性別	性別	xìngbié	/gender/
性格	性格	xìnggé	/nature/
幸好	幸好	xìnghǎo	/fortunately/
幸虧	幸虧	xìngkuī	/fortunately/
幸運	幸運	xìngyùn	/fortunate/
兇	兇	xiōng	/terrible/
兄弟	兄弟	xiōngdì	/brothers/
熊貓	熊貓	xióngmāo	/panda/
修	修	xiū	/dried meat/
修改	修改	xiūgǎi	/to amend/
修理	修理	xiūlǐ	/to repair/
需求	需求	xūqiú	/requirement/
選	選	xuǎn	/to choose/
選舉	選舉	xuǎnjǔ	/to elect/
選擇	選擇	xuǎnzé	/to select/
學會	學會	xuéhuì	/to learn/
學問	學問	xuéwèn	/learning/
尋找	尋找	xúnzhǎo	/to seek/
訓練	訓練	xùnliàn	/to train/
呀	呀	yā	/(particle equivalent to 啊 after a vowel, expressing surprise or doubt)/
鴨	鴨	yā	/duck/
押金	押金	yājīn	/deposit/
牙齒	牙齒	yáchǐ	/tooth/
煙火	煙火	yānhuǒ	/smoke and fire/
研究	研究	yánjiù	/research/
嚴重	嚴重	yánzhòng	/grave/
演出	演出	yǎnchū	/to act (in a play)/
演講	演講	yǎnjiǎng	/lecture/
演員	演員	yǎnyuán	/actor or actress/
眼光	眼光	yǎnguāng	/gaze/
眼淚	眼淚	yǎnlèi	/tears/
陽光	陽光	yángguāng	/sunshine/
樣樣	樣樣	yàngyàng	/all kinds/
邀請	邀請	yāoqǐng	/to invite/
要求	要求	yāoqiú	/to request/
咬	咬	yǎo	/variant of 咬[yao3]/
要不然	要不然	yàobùrán	/otherwise/
要不是	要不是	yàobúshì	/if it were not for/
要緊	要緊	yàojǐn	/important/
野餐	野餐	yěcān	/picnic/
也好	也好	yěhǎo	//
頁	頁	yè	/page/
夜裡	夜裡	yèli	/during the night/
夜市	夜市	yèshì	/night market/
一下子	一下子	yīxiàzi	/in a short while/
衣櫃	衣櫃	yīguì	/wardrobe/
依靠	依靠	yīkào	/to rely on sth (for support etc)/
一塊	一塊	yīkuài	/one block/
一切	一切	yīqiè	/everything/
一向	一向	yīxiàng	/always (previously)/
以來	以來	yǐlái	/since (a previous event)/
以免	以免	yǐmiǎn	/in order to avoid/
以內	以內	yǐnèi	/within/
以上	以上	yǐshàng	/that level or higher/
以外	以外	yǐwài	/apart from/
以為	以為	yǐwéi	/to think (i.e. to take it to be true that ...) (Usually there is an implication that the notion is mistaken – except when expressing one's own current opinion.)/
以下	以下	yǐxià	/that level or lower/
一般來說	一般來說	yìbānláishuō	/generally speaking/
一方面	一方面	yìfāngmiàn	/on the one hand/
一連	一連	yìlián	/in a row/
一生	一生	yìshēng	/all one's life/
一時	一時	yìshí	/a period of time/
一同	一同	yìtóng	/along/
意見	意見	yìjiàn	/idea/
意外	意外	yìwài	/unexpected/
意義	意義	yìyì	/sense/
陰	陰	yīn	/overcast (weather)/
因此	因此	yīncǐ	/thus/
音響	音響	yīnxiǎng	/sound/
引起	引起	yǐnqǐ	/to give rise to/
英俊	英俊	yīngjùn	/handsome/
營養	營養	yíngyǎng	/nutrition/
影片	影片	yǐngpiàn	/film/
擁有	擁有	yǒngyǒu	/to have/
用法	用法	yòngfǎ	/usage/
用功	用功	yònggōng	/diligent/
用品	用品	yòngpǐn	/articles for use/
優點	優點	yōudiǎn	/merit/
優秀	優秀	yōuxiù	/outstanding/
幽默	幽默	yōumò	/(loanword) humor/
郵票	郵票	yóupiào	/(postage) stamp/
尤其	尤其	yóuqí	/especially/
遊客	遊客	yóukè	/traveler/
游泳池	游泳池	yóuyǒngchí	/swimming pool/
由於	由於	yóuyú	/due to/
有點兒	有點兒	yǒudiǎnr	/slightly/
有的	有的	yǒude	/(there are) some (who are...)/
有名	有名	yǒumíng	/famous/
有錢	有錢	yǒuqián	/well-off/
有效	有效	yǒuxiào	/effective/
有意思	有意思	yǒuyìsi	/interesting/
友誼	友誼	yǒuyì	/companionship/
於是	於是	yúshì	/thereupon/
與	與	yǔ	/and/
玉	玉	yù	/jade/
玉米	玉米	yùmi	/corn/
預備	預備	yùbèi	/to prepare/
預習	預習	yùxí	/to prepare a lesson/
遇到	遇到	yùdào	/to meet/
員工	員工	yuángōng	/staff/
原諒	原諒	yuánliàng	/to excuse/
原因	原因	yuányīn	/cause/
願望	願望	yuànwàng	/desire/
院子	院子	yuànzi	/courtyard/
約會	約會	yuēhuì	/appointment/
越	越	yuè	/generic word for peoples or states of south China or south Asia at different historical periods/
月餅	月餅	yuèbǐng	/mooncake (esp. for the Mid-Autumn Festival)/
閱讀	閱讀	yuèdú	/to read/
樂團	樂團	yuètuán	/band/
運氣	運氣	yùnqì	/luck (good or bad)/
在意	在意	zàiyì	/to care about/
在於	在於	zàiyú	/to be in/
早日	早日	zǎorì	/soon/
早晚	早晚	zǎowǎn	/morning and evening/
造成	造成	zàochéng	/to bring about/
噪音	噪音	zàoyīn	/rumble/
責任	責任	zérèn	/responsibility/
增加	增加	zēngjiā	/to raise/
炸	炸	zhà	/to deep fry/
摘	摘	zhāi	/to take/
暫時	暫時	zhànshí	/temporary/
戰爭	戰爭	zhànzhēng	/war/
長大	長大	zhǎngdà	/to grow up/
掌握	掌握	zhǎngwò	/to grasp (often fig.)/
障礙	障礙	zhàngài	/barrier/
招待	招待	zhāodài	/to receive (guests)/
招牌	招牌	zhāopái	/signboard/
找錢	找錢	zhǎoqián	/to give change/
哲學	哲學	zhéxué	/philosophy/
這裏	這裏	zhèlǐ	/variant of 這裡|这里[zhe4 li3]/
這下子	這下子	zhèxiàzi	/this time/
這樣	這樣	zhèyàng	/this kind of/
這樣子	這樣子	zhèyàngzi	/so/
真的	真的	zhēnde	//
真理	真理	zhēnlǐ	/truth/
真實	真實	zhēnshí	/true/
真是	真是	zhēnshì	/indeed/
真心	真心	zhēnxīn	/sincere/
真正	真正	zhēnzhèng	/genuine/
珍貴	珍貴	zhēnguì	/precious/
整	整	zhěng	/exactly/
整理	整理	zhěnglǐ	/to arrange/
整齊	整齊	zhěngqí	/orderly/
正常	正常	zhèngcháng	/regular/
正確	正確	zhèngquè	/correct/
正式	正式	zhèngshì	/formal/
證明	證明	zhèngmíng	/proof/
證書	證書	zhèngshū	/credentials/
支	支	zhī	/to support/
知識	知識	zhīshì	/knowledge/
之後	之後	zhīhòu	/afterwards/
之間	之間	zhījiān	/between/
之前	之前	zhīqián	/before/
直到	直到	zhídào	/until/
值得	值得	zhíde	/to be worth/
殖民地	殖民地	zhímíndì	/colony/
植物	植物	zhíwù	/plant/
職員	職員	zhíyuán	/office worker/
只是	只是	zhǐshì	/merely/
只要	只要	zhǐyào	/if only/
只有	只有	zhǐyǒu	//
制度	制度	zhìdù	/system (e.g. political, adminstrative etc)/
智慧	智慧	zhìhuì	/wisdom/
至少	至少	zhìshǎo	/at least/
至於	至於	zhìyú	/as for/
中部	中部	zhōngbù	/middle part/
中餐	中餐	zhōngcān	/Chinese meal/
終於	終於	zhōngyú	/at last/
重點	重點	zhòngdiǎn	/to recount (e.g. results of election)/
重視	重視	zhòngshì	/to attach importance to sth/
周圍	周圍	zhōuwéi	/surroundings/
主動	主動	zhǔdòng	/to take the initiative/
主婦	主婦	zhǔfù	/housewife/
主管	主管	zhǔguǎn	/in charge/
主人	主人	zhǔrén	/master/
主任	主任	zhǔrèn	/director/
主題	主題	zhǔtí	/theme/
主要	主要	zhǔyào	/main/
主意	主意	zhǔyì	/plan/
祝福	祝福	zhùfú	/blessings/
助理	助理	zhùlǐ	/assistant/
著名	著名	zhùmíng	/famous/
抓	抓	zhuā	/to grab/
專心	專心	zhuānxīn	/to concentrate/
專業	專業	zhuānyè	/specialty/
狀態	狀態	zhuàngtài	/state of affairs/
追求	追求	zhuīqiú	/to pursue (a goal etc) stubbornly/
準時	準時	zhǔnshí	/on time/
資料	資料	zīliào	/material/
資源	資源	zīyuán	/natural resource (such as water or minerals)/
仔細	仔細	zǐxì	/careful/
自從	自從	zìcóng	/since (a time)/
自動	自動	zìdòng	/automatic/
自然	自然	zìrán	/nature/
自殺	自殺	zìshā	/to kill oneself/
自信	自信	zìxìn	/to have confidence in oneself/
自由	自由	zìyóu	/freedom/
自在	自在	zìzài	/free/
宗教	宗教	zōngjiào	/religion/
總而言之	總而言之	zǒngéryánzhī	/in short/
總算	總算	zǒngsuàn	/at long last/
總統	總統	zǒngtǒng	/president (of a country)/
總之	總之	zǒngzhī	/in a word/
走走	走走	zǒuzou	//
祖父	祖父	zǔfù	/father's father/
祖母	祖母	zǔmǔ	/father's mother/
祖先	祖先	zǔxiān	/ancestor/
醉	醉	zuì	/intoxicated/
最初	最初	zuìchū	/first/
最多	最多	zuìduō	/at most/
最好	最好	zuìhǎo	/best/
最佳	最佳	zuìjiā	/optimum/
尊敬	尊敬	zūnjìng	/to respect/
作品	作品	zuòpǐn	/work (of art)/
作者	作者	zuòzhě	/author/
做夢	做夢	zuòmèng	/to dream/
做人	做人	zuòrén	/to conduct oneself/
做事	做事	zuòshì	/to work/
