挨	挨	āi	/in order/
欸	欸	ǎi	/sigh/
愛戴	愛戴	àidài	/to love and respect/
愛國	愛國	àiguó	/to love one's country/
愛滋病	愛滋病	àizībìng	/variant of 艾滋病[ai4 zi1 bing4]/
安頓	安頓	āndùn	/to find a place for/
安撫	安撫	ānfǔ	/to placate/
安寧	安寧	ānníng	/peaceful/
安詳	安詳	ānxiáng	/serene/
安置	安置	ānzhì	/to find a place for/
暗暗	暗暗	ànàn	/secretly/
案件	案件	ànjiàn	/case/
案情	案情	ànqíng	/details of a case/
案子	案子	ànzi	/long table/
按摩	按摩	ànmó	/massage/
昂貴	昂貴	ángguì	/expensive/
奧妙	奧妙	àomiào	/marvelous/
懊惱	懊惱	àonǎo	/annoyed/
八卦	八卦	bāguà	/the eight divinatory trigrams of the Book of Changes 易經|易经[Yi4 jing1]/
八字	八字	bāzì	/the character 8 or 八/
把持	把持	bǎchí	/to control/
把手	把手	bǎshǒu	/to shake hands/
白皮書	白皮書	báipíshū	/white paper (e.g. containing proposals for new legislation)/
拜會	拜會	bàihuì	/pay an official call/
頒發	頒發	bānfā	/to issue/
頒獎	頒獎	bānjiǎng	/to confer an award/
辦案	辦案	bànàn	/to handle a case/
半島	半島	bàndǎo	/peninsula/
半導體	半導體	bàndǎotǐ	/semiconductor/
綁	綁	bǎng	/to tie/
包袱	包袱	bāofu	/wrapping cloth/
包圍	包圍	bāowéi	/to surround/
寶石	寶石	bǎoshí	/precious stone/
飽和	飽和	bǎohé	/saturation/
飽滿	飽滿	bǎomǎn	/full/
保安	保安	bǎoān	/to ensure public security/
保管	保管	bǎoguǎn	/to hold in safekeeping/
保齡球	保齡球	bǎolíngqiú	/ten-pin bowling (loanword)/
保姆	保姆	bǎomǔ	/nanny/
保全	保全	bǎoquán	/to save from damage/
保佑	保佑	bǎoyòu	/to bless and protect/
保重	保重	bǎozhòng	/to take care of oneself/
報案	報案	bàoàn	/to report a case to the authorities/
報表	報表	bàobiǎo	/forms for reporting statistics/
報酬	報酬	bàochóu	/reward/
報復	報復	bàofù	/to make reprisals/
報關	報關	bàoguān	/to declare at customs/
報價	報價	bàojià	/to quote a price/
報刊	報刊	bàokān	/newspapers and periodicals/
報應	報應	bàoyìng	/retribution/
報章	報章	bàozhāng	/newspapers/
暴雨	暴雨	bàoyǔ	/torrential rain/
爆發	爆發	bàofā	/to break out/
抱負	抱負	bàofù	/aspiration/
抱歉	抱歉	bàoqiàn	/to be sorry/
碑	碑	bēi	/a monument/
悲哀	悲哀	bēiāi	/grieved/
悲觀	悲觀	bēiguān	/pessimistic/
貝殼	貝殼	bèiké	/shell/
倍數	倍數	bèishù	/multiple/
背誦	背誦	bèisòng	/to recite/
背心	背心	bèixīn	/sleeveless garment (vest, waistcoat, singlet, tank top etc)/
被子	被子	bèizi	/quilt/
奔騰	奔騰	bēnténg	/Pentium (microprocessor by Intel)/
本事	本事	běnshì	/source material/
本位	本位	běnwèi	/standard/
本性	本性	běnxìng	/natural instincts/
本質	本質	běnzhí	/essence/
崩潰	崩潰	bēngkuì	/to collapse/
甭	甭	béng	/need not/
敝	敝	bì	/my (polite)/
編輯	編輯	biānjí	/to edit/
編寫	編寫	biānxiě	/to compile/
編織	編織	biānzhī	/to weave/
編制	編制	biānzhì	/to establish (a unit or department)/
編製	編製	biānzhì	/to weave/
邊界	邊界	biānjiè	/boundary/
邊緣	邊緣	biānyuán	/edge/
貶	貶	biǎn	/to diminish/
貶值	貶值	biǎnzhí	/to become devaluated/
匾額	匾額	biǎné	/a horizontal inscribed board/
辨認	辨認	biànrèn	/to recognize/
辨識	辨識	biànshì	/identification/
辯	辯	biàn	/to dispute/
辯護	辯護	biànhù	/to speak in defense of/
辯論	辯論	biànlùn	/debate/
變革	變革	biàngé	/to transform/
變遷	變遷	biànqiān	/changes/
變通	變通	biàntōng	/pragmatic/
變形	變形	biànxíng	/deformation/
標籤	標籤	biāoqiān	/label/
標語	標語	biāoyǔ	/written slogan/
表白	表白	biǎobái	/to explain oneself/
表明	表明	biǎomíng	/to make clear/
鼻孔	鼻孔	bíkǒng	/nostril/
鼻涕	鼻涕	bítì	/nasal mucus/
筆錄	筆錄	bǐlù	/to put down in writing/
筆友	筆友	bǐyǒu	/pen pal/
比率	比率	bǐlǜ	/ratio/
比擬	比擬	bǐnǐ	/to compare/
比喻	比喻	bǐyù	/to compare/
比重	比重	bǐzhòng	/proportion/
必備	必備	bìbèi	/essential/
必定	必定	bìdìng	/to be bound to/
必然	必然	bìrán	/inevitable/
閉幕	閉幕	bìmù	/the curtain falls/
閉塞	閉塞	bìsè	/to stop up/
避難	避難	bìnàn	/refuge/
避孕	避孕	bìyùn	/contraception/
畢生	畢生	bìshēng	/all one's life/
幣值	幣值	bìzhí	/value of a currency/
憋	憋	biē	/to choke/
別墅	別墅	biéshù	/villa/
兵	兵	bīng	/soldiers/
賓館	賓館	bīnguǎn	/guesthouse/
柄	柄	bǐng	/handle or shaft (of an axe etc)/
並列	並列	bìngliè	/to stand side by side/
並重	並重	bìngzhòng	/to lay equal stress on/
併發	併發	bìngfā	/to be complicated by/
病床	病床	bìngchuáng	/hospital bed/
病菌	病菌	bìngjùn	/harmful bacteria/
病情	病情	bìngqíng	/state of an illness/
波及	波及	bōjí	/to spread to/
波浪	波浪	bōlàng	/wave/
剝	剝	bō	/to peel/
剝削	剝削	bōxuè	/to exploit/
搏鬥	搏鬥	bódòu	/to wrestle/
播出	播出	bòchū	/to broadcast/
補給	補給	bǔjǐ	/supply/
補救	補救	bǔjiù	/to remedy/
補習班	補習班	bǔxíbān	/cram class/
哺乳動物	哺乳動物	bǔrǔdòngwù	/mammal/
不便	不便	bùbiàn	/inconvenient/
不得	不得	bùdé	/must not/
不等	不等	bùděng	/unequal/
不動產	不動產	bùdòngchǎn	/real estate/
不法	不法	bùfǎ	/lawless/
不凡	不凡	bùfán	/out of the ordinary/
不妨	不妨	bùfáng	/there is no harm in/
不公	不公	bùgōng	/unjust/
不及	不及	bùjí	/to fall short of/
不禁	不禁	bùjīn	/can't help (doing sth)/
不堪	不堪	bùkān	/cannot bear/
不力	不力	bùlì	/not to do one's best/
不料	不料	bùliào	/unexpectedly/
不免	不免	bùmiǎn	/inevitably/
不容	不容	bùróng	/must not/
不時	不時	bùshí	/from time to time/
不惜	不惜	bùxí	/not stint/
不下	不下	bùxià	/to be not less than (a certain quantity, amount etc)/
不肖	不肖	bùxiào	/(literary) unlike one's parents/
不懈	不懈	bùxiè	/untiring/
不再	不再	bùzài	/no more/
不致	不致	bùzhì	/not in such a way as to/
不知不覺	不知不覺	bùzhībùjué	/unconsciously/
不至	不至	bùzhìyú	//
部落	部落	bùluò	/tribe/
部署	部署	bùshù	/to dispose/
步調	步調	bùdiào	/gait/
步驟	步驟	bùzòu	/procedure/
猜測	猜測	cāicè	/to guess/
猜忌	猜忌	cāijì	/to be suspicious and jealous of/
猜想	猜想	cāixiǎng	/to guess/
裁縫	裁縫	cáiféng	/tailor/
裁減	裁減	cáijiǎn	/to reduce/
財團	財團	cáituán	/financial group/
財政	財政	cáizhèng	/finances (public)/
才智	才智	cáizhì	/ability and wisdom/
採訪	採訪	cǎifǎng	/to interview/
採光	採光	cǎiguāng	/lighting/
採納	採納	cǎinà	/to accept/
採取	採取	cǎiqǔ	/to adopt or carry out (measures, policies, course of action)/
彩繪	彩繪	cǎihuì	/painted/
餐具	餐具	cānjù	/tableware/
參謀	參謀	cānmóu	/staff officer/
殘暴	殘暴	cánbào	/brutal/
殘酷	殘酷	cánkù	/cruel/
殘殺	殘殺	cánshā	/to massacre/
慘重	慘重	cǎnzhòng	/disastrous/
燦爛	燦爛	cànlàn	/to glitter/
蒼白	蒼白	cāngbái	/pale/
蒼蠅	蒼蠅	cāngying	/housefly/
操縱	操縱	cāozòng	/to operate/
草案	草案	cǎoàn	/draft (legislation, proposal etc)/
草叢	草叢	cǎocóng	/underbrush/
草率	草率	cǎoshuài	/careless/
草藥	草藥	cǎoyào	/herbal medicine/
策畫	策畫	cèhuà	/variant of 策劃|策划[ce4 hua4]/
差額	差額	chāé	/balance (financial)/
插曲	插曲	chāqǔ	/music played during a movie, play etc/
插嘴	插嘴	chāzuǐ	/to interrupt (sb talking)/
茶具	茶具	chájù	/tea set/
察覺	察覺	chájué	/to sense/
查明	查明	chámíng	/to investigate and find out/
蟬	蟬	chán	/cicada/
饞	饞	chán	/gluttonous/
潺潺	潺潺	chánchán	/murmur/
猖獗	猖獗	chāngjué	/to be rampant/
長遠	長遠	chángyuǎn	/long-term/
場次	場次	chǎngcì	/the number of showings of a movie, play etc/
場面	場面	chǎngmiàn	/scene/
倡導	倡導	chàngdǎo	/to advocate/
唱腔	唱腔	chàngqiāng	/vocal music (in opera)/
暢銷	暢銷	chàngxiāo	/to sell well/
產物	產物	chǎnwù	/product/
產值	產值	chǎnzhí	/value of output/
超速	超速	chāosù	/to exceed the speed limit/
超脫	超脫	chāotuō	/to stand aloof/
抄襲	抄襲	chāoxí	/to plagiarize/
吵嘴	吵嘴	chǎozuǐ	/to quarrel/
車輛	車輛	chēliàng	/vehicle/
車廂	車廂	chēxiāng	/carriage/
撤回	撤回	chèhuí	/to recall/
撤銷	撤銷	chèxiāo	/to repeal/
沉默	沉默	chénmò	/taciturn/
沉思	沉思	chénsī	/to contemplate/
沉重	沉重	chénzhòng	/heavy/
塵土	塵土	chéntǔ	/dust/
承包	承包	chéngbāo	/to contract/
承擔	承擔	chéngdān	/to undertake/
承諾	承諾	chéngnuò	/to promise/
成敗	成敗	chéngbài	/success or failure/
成見	成見	chéngjiàn	/preconceived idea/
成品	成品	chéngpǐn	/finished goods/
成全	成全	chéngquán	/to help sb accomplish his aim/
成人	成人	chéngrén	/adult/
成效	成效	chéngxiào	/effect/
成衣	成衣	chéngyī	/ready-made clothes/
成員	成員	chéngyuán	/member/
稱號	稱號	chēnghào	/name/
稱呼	稱呼	chēnghū	/to call/
撐腰	撐腰	chēngyāo	/to support/
程式	程式	chéngshì	/form/
呈獻	呈獻	chéngxiàn	/to present respectfully/
誠心	誠心	chéngxīn	/sincerity/
誠心誠意	誠心誠意	chéngxīnchéngyì	/earnestly and sincerely (idiom); with all sincerity/
誠摯	誠摯	chéngzhì	/sincere/
吃驚	吃驚	chījīng	/to be startled/
吃苦	吃苦	chīkǔ	/to bear hardships/
吃力	吃力	chīlì	/to entail strenuous effort/
持久	持久	chíjiǔ	/lasting/
持平	持平	chípíng	/to stay level (of exchange rate, market share etc)/
持續	持續	chíxù	/to continue/
遲鈍	遲鈍	chídùn	/slow in one's reactions/
充斥	充斥	chōngchì	/to be full of/
充裕	充裕	chōngyù	/abundant/
沖淡	沖淡	chōngdàn	/to dilute/
沖天	沖天	chōngtiān	/to soar/
衝	衝	chōng	/thoroughfare/
衝動	衝動	chōngdòng	/to have an urge/
衝擊	衝擊	chōngjí	/to attack/
衝突	衝突	chōngtú	/conflict/
憧憬	憧憬	chōngjǐng	/to long for/
重疊	重疊	chóngdié	/to overlap/
崇尚	崇尚	chóngshàng	/to hold up (as an model)/
寵愛	寵愛	chǒngài	/to dote on sb/
寵物	寵物	chǒngwù	/house pet/
抽查	抽查	chōuchá	/random inspection/
抽空	抽空	chōukòng	/to find the time to do sth/
抽象	抽象	chōuxiàng	/abstract/
抽樣	抽樣	chōuyàng	/sample/
仇恨	仇恨	chóuhèn	/to hate/
稠密	稠密	chóumì	/dense/
出超	出超	chūchāo	/trade surplus/
出錯	出錯	chūcuò	/to make a mistake/
出發點	出發點	chūfādiǎn	/starting point/
出局	出局	chūjú	/to send off (player for a foul)/
出力	出力	chūlì	/to exert oneself/
出路	出路	chūlù	/a way out (lit. and fig.)/
出馬	出馬	chūmǎ	/to set out (on a campaign)/
出賣	出賣	chūmài	/to offer for sale/
出面	出面	chūmiàn	/to appear personally/
出名	出名	chūmíng	/well-known for sth/
出品	出品	chūpǐn	/to produce an item/
出示	出示	chūshì	/to show/
出手	出手	chūshǒu	/to dispose of/
出頭	出頭	chūtóu	/to get out of a predicament/
出土	出土	chūtǔ	/to dig up/
出息	出息	chūxi	/to yield interest, profit etc/
出血	出血	chūxiě	/to bleed/
初期	初期	chūqí	/initial stage/
儲備	儲備	chúbèi	/reserves/
除此之外	除此之外	chúcǐzhīwài	/apart from this/
鋤頭	鋤頭	chútou	/hoe/
處方	處方	chǔfāng	/medical prescription/
處分	處分	chǔfèn	/to discipline sb/
處境	處境	chǔjìng	/situation (of a person)/
處事	處事	chǔshì	/to handle affairs/
處於	處於	chǔyú	/to be in (some state, position, or condition)/
處女	處女	chǔnǚ	/virgin/
穿梭	穿梭	chuānsuō	/to travel back and forth/
傳遞	傳遞	chuándì	/to transmit/
傳奇	傳奇	chuánqí	/legendary/
傳神	傳神	chuánshén	/vivid/
傳授	傳授	chuánshòu	/to impart/
船隻	船隻	chuánzhī	/ship/
喘	喘	chuǎn	/to gasp/
創傷	創傷	chuāngshāng	/wound/
創辦	創辦	chuàngbàn	/to establish/
創立	創立	chuànglì	/to establish/
創新	創新	chuàngxīn	/innovation/
創業	創業	chuàngyè	/to begin an undertaking/
吹牛	吹牛	chuīniú	/to talk big/
垂	垂	chuí	/to hang (down)/
垂直	垂直	chuízhí	/perpendicular/
辭典	辭典	cídiǎn	/dictionary (of Chinese compound words)/
辭行	辭行	cíxíng	/to say goodbye/
慈善	慈善	císhàn	/benevolent/
此刻	此刻	cǐkè	/this moment/
次要	次要	cìyào	/secondary/
伺候	伺候	cìhou	/to serve/
刺殺	刺殺	cìshā	/to assassinate/
匆忙	匆忙	cōngmáng	/hasty/
從容	從容	cōngróng	/to go easy/
從而	從而	cóngér	/thus/
湊巧	湊巧	còuqiǎo	/fortuitously/
粗糙	粗糙	cūcāo	/crude/
粗魯	粗魯	cūlǔ	/coarse/
促成	促成	cùchéng	/to facilitate/
促使	促使	cùshǐ	/to induce/
促銷	促銷	cùxiāo	/to promote sales/
簇擁	簇擁	cùyǒng	/to crowd around/
摧殘	摧殘	cuīcán	/to ravage/
摧毀	摧毀	cuīhuǐ	/to destroy/
催眠	催眠	cuīmián	/hypnosis/
脆弱	脆弱	cuìruò	/weak/
存貨	存貨	cúnhuò	/stock/
磋商	磋商	cuōshāng	/to consult/
撮合	撮合	cuòhé	/to play matchmaker/
搭配	搭配	dāpèi	/to pair up/
答覆	答覆	dáfù	/to answer/
打鬥	打鬥	dǎdòu	/to fight/
打賭	打賭	dǎdǔ	/to bet/
打發	打發	dǎfa	/to dispatch sb to do sth/
打擊	打擊	dǎjí	/to hit/
打量	打量	dǎliàng	/to size sb up/
打獵	打獵	dǎliè	/to go hunting/
打牌	打牌	dǎpái	/to play mahjong or cards/
打手	打手	dǎshǒu	/hired thug/
打烊	打烊	dǎyáng	/to close shop in the evening/
大道	大道	dàdào	/main street/
大隊	大隊	dàduì	/group/
大使	大使	dàshǐ	/ambassador/
大選	大選	dàxuǎn	/general election/
大洋洲	大洋洲	dàyángzhōu	/Oceania/
呆	呆	dāi	/foolish/
歹徒	歹徒	dǎitú	/evildoer/
逮捕	逮捕	dǎibǔ	/to arrest/
代課	代課	dàikè	/to teach as substitute for absent teacher/
怠慢	怠慢	dàimàn	/to slight/
擔當	擔當	dāndāng	/to take upon oneself/
擔負	擔負	dānfù	/to shoulder/
單獨	單獨	dāndú	/alone/
單價	單價	dānjià	/unit price/
單據	單據	dānjù	/receipts/
單親	單親	dānqīn	/single parent/
單行道	單行道	dānxíngdào	/one-way street/
膽固醇	膽固醇	dǎngùchún	/cholesterol/
淡季	淡季	dànjì	/off season/
淡水	淡水	dànshuǐ	/potable water (water with low salt content)/
導師	導師	dǎoshī	/tutor/
導致	導致	dǎozhì	/to lead to/
島嶼	島嶼	dǎoyǔ	/island/
道別	道別	dàobié	/leave taking/
道地	道地	dàodì	/authentic/
道士	道士	dàoshì	/Daoist priest/
道義	道義	dàoyì	/morality/
到期	到期	dàoqí	/to fall due (loan etc)/
到頭來	到頭來	dàotóulái	/in the end/
倒數	倒數	dàoshǔ	/to count backwards (from 10 down to 0)/
當兵	當兵	dāngbīng	/to serve in the army/
當代	當代	dāngdài	/the present age/
當局	當局	dāngjú	/authorities/
當前	當前	dāngqián	/current/
當心	當心	dāngxīn	/to take care/
黨派	黨派	dǎngpài	/political party/
黨員	黨員	dǎngyuán	/political party member/
得以	得以	déyǐ	/able to/
登場	登場	dēngchǎng	/to go on stage/
登陸	登陸	dēnglù	/to land/
燈火	燈火	dēnghuǒ	/lights/
燈籠	燈籠	dēnglong	/lantern/
等候	等候	děnghòu	/to wait/
等價	等價	děngjià	/equal/
瞪	瞪	dèng	/to open (one's eyes) wide/
嘀咕	嘀咕	dígu	/to mutter/
底片	底片	dǐpiàn	/negative/
抵押	抵押	dǐyā	/to provide (an asset) as security for a loan/
抵制	抵制	dǐzhì	/to resist/
地表	地表	dìbiǎo	/the surface (of the earth)/
地步	地步	dìbù	/stage/
地勢	地勢	dìshì	/terrain/
地域	地域	dìyù	/area/
地獄	地獄	dìyù	/hell/
地質	地質	dìzhí	/geology/
地主	地主	dìzhǔ	/landlord/
締結	締結	dìjié	/to conclude (an agreement)/
締造	締造	dìzào	/to found/
弟兄	弟兄	dìxiong	/brothers/
顛覆	顛覆	diānfù	/to topple (i.e. knock over)/
典雅	典雅	diǎnyǎ	/refined/
點子	點子	diǎnzi	/spot/
奠定	奠定	diàndìng	/to establish/
惦記	惦記	diànjì	/to think of/
電工	電工	diàngōng	/electrician/
電力	電力	diànlì	/electrical power/
電流	電流	diànliú	/electric current/
電器	電器	diànqì	/(electrical) appliance/
電視劇	電視劇	diànshìjù	/TV play/
電壓	電壓	diànyā	/voltage/
凋零	凋零	diāolíng	/withered/
調度	調度	diàodù	/to dispatch (vehicles, staff etc)/
吊橋	吊橋	diàoqiáo	/drawbridge/
釣魚	釣魚	diàoyú	/to fish (with line and hook)/
定額	定額	dìngé	/fixed amount/
定義	定義	dìngyì	/definition/
釘	釘	dìng	/nail/
訂購	訂購	dìnggòu	/to place an order/
丟棄	丟棄	diūqì	/to discard/
凍結	凍結	dòngjié	/to freeze (water etc)/
洞穴	洞穴	dòngxuè	/cave/
動產	動產	dòngchǎn	/movable property/
動機	動機	dòngjī	/motor/
動靜	動靜	dòngjìng	/(detectable) movement/
動力	動力	dònglì	/motive power/
動亂	動亂	dòngluàn	/turmoil/
動脈	動脈	dòngmài	/artery/
動態	動態	dòngtài	/movement/
動向	動向	dòngxiàng	/trend/
動員	動員	dòngyuán	/to mobilize/
陡	陡	dǒu	/steep/
逗留	逗留	dòuliú	/to stay at/
鬥志	鬥志	dòuzhì	/will to fight/
督促	督促	dūcù	/to supervise and urge completion of a task/
獨創	獨創	dúchuàng	/to come up with (an innovation)/
獨到	獨到	dúdào	/original/
獨占	獨占	dúzhàn	//
讀物	讀物	dúwù	/reading material/
堵	堵	dǔ	/to stop up/
堵塞	堵塞	dǔsè	/to clog up/
賭博	賭博	dǔbó	/to gamble/
賭場	賭場	dǔchǎng	/casino/
度量衡	度量衡	dùliànghéng	/measurement/
端正	端正	duānzhèng	/upright/
短缺	短缺	duǎnquē	/shortage/
短暫	短暫	duǎnzhàn	/of short duration/
斷絕	斷絕	duànjué	/to sever/
堆積	堆積	duījī	/to pile up/
隊伍	隊伍	duìwǔ	/ranks/
兌現	兌現	duìxiàn	/(of a check etc) to cash/
對比	對比	duìbǐ	/to contrast/
對照	對照	duìzhào	/to contrast/
對峙	對峙	duìzhì	/to stand opposite/
頓時	頓時	dùnshí	/immediately/
多寡	多寡	duōguǎ	/number/
多虧	多虧	duōkuī	/thanks to/
多媒體	多媒體	duōméitǐ	/multimedia/
多元	多元	duōyuán	/poly-/
奪魁	奪魁	duókuí	/to seize/
躲避	躲避	duǒbì	/to hide/
墮胎	墮胎	duòtāi	/to induce an abortion/
額外	額外	éwài	/extra/
惡化	惡化	èhuà	/to worsen/
惡性	惡性	èxìng	/malignant/
惡意	惡意	èyì	/malice/
恩愛	恩愛	ēnài	/loving affection (in a couple)/
恩情	恩情	ēnqíng	/kindness/
恩人	恩人	ēnrén	/a benefactor/
恩怨	恩怨	ēnyuàn	/gratitude and grudges/
而是	而是	érshì	/rather/
而言	而言	éryán	/with regard to (preceding phrase)/
兒女	兒女	érnǚ	/children/
耳光	耳光	ěrguāng	/a slap on the face/
發電	發電	fādiàn	/to generate electricity/
發瘋	發瘋	fāfēng	/to go mad/
發掘	發掘	fājué	/to excavate/
發誓	發誓	fāshì	/to vow/
發炎	發炎	fāyán	/to become inflamed/
發育	發育	fāyù	/to develop/
發作	發作	fāzuò	/to flare up/
法定	法定	fǎdìng	/legal/
法官	法官	fǎguān	/judge/
法令	法令	fǎlìng	/decree/
法人	法人	fǎrén	/legal person/
法則	法則	fǎzé	/law/
法制	法制	fǎzhì	/made in France/
法治	法治	fǎzhì	/rule of law/
翻臉	翻臉	fānliǎn	/to fall out with sb/
翻身	翻身	fānshēn	/to turn over (when lying)/
翻新	翻新	fānxīn	/to revamp/
繁多	繁多	fánduō	/many and varied/
繁體	繁體	fántǐ	/traditional form of Chinese, as opposed to simplified form 簡體|简体[jian3 ti3]/
藩籬	藩籬	fánlí	/hedge/
反擊	反擊	fǎnjí	/to strike back/
反射	反射	fǎnshè	/to reflect/
反省	反省	fǎnxǐng	/to reflect upon oneself/
反之	反之	fǎnzhī	/on the other hand.../
犯規	犯規	fànguī	/to break the rules/
販毒	販毒	fàndú	/to traffic narcotics/
販賣	販賣	fànmài	/to sell/
方位	方位	fāngwèi	/direction/
方向盤	方向盤	fāngxiàngpán	/steering wheel/
方針	方針	fāngzhēn	/policy/
方正	方正	fāngzhèng	/clear and square/
妨礙	妨礙	fángài	/to hinder/
防備	防備	fángbèi	/to guard against/
防範	防範	fángfàn	/to be on guard/
防水	防水	fángshuǐ	/waterproof/
防衛	防衛	fángwèi	/to defend/
防禦	防禦	fángyù	/defense/
防治	防治	fángzhì	/prevention and cure/
仿冒	仿冒	fǎngmào	/to counterfeit/
仿造	仿造	fǎngzào	/to copy/
紡織	紡織	fǎngzhī	/spinning and weaving/
放蕩	放蕩	fàngdàng	/unconventional/
放寬	放寬	fàngkuān	/to relax restrictions/
放款	放款	fàngkuǎn	/to lend money (as a commercial loan)/
放任	放任	fàngrèn	/to ignore/
放鬆	放鬆	fàngsōng	/to loosen/
放映	放映	fàngyìng	/to show (a movie)/
放逐	放逐	fàngzhú	/to banish/
非凡	非凡	fēifán	/out of the ordinary/
非洲	非洲	fēizhōu	/Africa/
飛彈	飛彈	fēidàn	/missile/
飛快	飛快	fēikuài	/very fast/
飛翔	飛翔	fēixiáng	/to circle in the air/
飛行	飛行	fēixíng	/(of planes etc) to fly/
肥料	肥料	féiliào	/fertilizer/
廢除	廢除	fèichú	/to abolish/
廢棄	廢棄	fèiqì	/to discard/
廢墟	廢墟	fèixū	/ruins/
廢止	廢止	fèizhǐ	/to repeal (a law)/
費力	費力	fèilì	/to expend a great deal of effort/
沸騰	沸騰	fèiténg	/(of a liquid) to boil/
肺炎	肺炎	fèiyán	/pneumonia/
分貝	分貝	fēnbèi	/decibel/
分辨	分辨	fēnbiàn	/to distinguish/
分寸	分寸	fēncùn	/propriety/
分擔	分擔	fēndān	/to share (a burden, a cost, a responsibility)/
分發	分發	fēnfā	/to distribute/
分割	分割	fēngē	/to cut up/
分化	分化	fēnhuà	/to split apart/
分級	分級	fēnjí	/to rank/
分家	分家	fēnjiā	/to separate and live apart/
分解	分解	fēnjiě	/to resolve/
分離	分離	fēnlí	/to separate/
分裂	分裂	fēnliè	/to split up/
分泌	分泌	fēnmì	/to secrete/
分享	分享	fēnxiǎng	/to share (let others have some of sth good)/
分子	分子	fēnzǐ	/one's share of a gift price/
墳墓	墳墓	fénmù	/grave/
粉紅	粉紅	fěnhóng	/pink/
粉刷	粉刷	fěnshuā	/to paint/
分量	分量	fènliàng	/(vector) component/
糞	糞	fèn	/manure/
封閉	封閉	fēngbì	/to seal/
封鎖	封鎖	fēngsuǒ	/to blockade/
封條	封條	fēngtiáo	/seal/
風暴	風暴	fēngbào	/storm/
風潮	風潮	fēngcháo	/tempest/
風光	風光	fēngguāng	/scene/
風化	風化	fēnghuà	/decency/
風力	風力	fēnglì	/wind force/
風尚	風尚	fēngshàng	/current custom/
風水	風水	fēngshui	/feng shui/
風行	風行	fēngxíng	/to become fashionable/
鋒面	鋒面	fēngmiàn	/front (meteorology)/
豐盛	豐盛	fēngshèng	/rich/
豐收	豐收	fēngshōu	/bumper harvest/
奉獻	奉獻	fèngxiàn	/to offer respectfully/
奉養	奉養	fèngyàng	/to look after (elderly parents)/
佛經	佛經	fójīng	/Buddhist texts/
佛像	佛像	fóxiàng	/Buddhist image/
否決	否決	fǒujué	/to veto/
膚淺	膚淺	fūqiǎn	/skin-deep/
敷衍	敷衍	fūyǎn	/to elaborate (on a theme)/
俘虜	俘虜	fúlǔ	/captive/
浮動	浮動	fúdòng	/to float and drift/
服從	服從	fúcóng	/to obey (an order)/
服飾	服飾	fúshì	/apparel/
服刑	服刑	fúxíng	/to serve a prison sentence/
幅度	幅度	fúdù	/width/
福氣	福氣	fúqì	/good fortune/
輻射	輻射	fúshè	/radiation/
斧頭	斧頭	fǔtou	/ax/
撫養	撫養	fǔyǎng	/to foster/
撫育	撫育	fǔyù	/to nurture/
腐爛	腐爛	fǔlàn	/to rot/
腐蝕	腐蝕	fǔshí	/corrosion/
腐朽	腐朽	fǔxiǔ	/rotten/
付款	付款	fùkuǎn	/to pay a sum of money/
負面	負面	fùmiàn	/negative/
富貴	富貴	fùguì	/riches and honor/
富有	富有	fùyǒu	/rich/
婦人	婦人	fùrén	/married woman/
附上	附上	fùshàng	/attached/
復甦	復甦	fùsū	/to recover (health, economic)/
復原	復原	fùyuán	/to restore (sth) to (its) former condition/
賦予	賦予	fùyǔ	/to assign/
該死	該死	gāisǐ	/Damn it!/
改編	改編	gǎibiān	/to adapt/
改觀	改觀	gǎiguān	/change of appearance/
改良	改良	gǎiliáng	/to improve (sth)/
改選	改選	gǎixuǎn	/reelection/
鈣	鈣	gài	/calcium (chemistry)/
概括	概括	gàiguā	/to summarize/
概況	概況	gàikuàng	/general situation/
蓋章	蓋章	gàizhāng	/to affix a seal/
尷尬	尷尬	gāngà	/awkward/
干擾	干擾	gānrǎo	/to disturb/
干涉	干涉	gānshè	/to interfere/
乾燥	乾燥	gānzào	/to dry (of weather, paint, cement etc)/
感觸	感觸	gǎnchù	/one's thoughts and feelings/
感性	感性	gǎnxìng	/perception/
趕忙	趕忙	gǎnmáng	/to hurry/
綱領	綱領	gānglǐng	/program (i.e. plan of action)/
剛強	剛強	gāngqiáng	/firm/
鋼鐵	鋼鐵	gāngtiě	/steel/
崗位	崗位	gǎngwèi	/a post/
高見	高見	gāojiàn	/wise opinion/
高壓	高壓	gāoyā	/high pressure/
告別	告別	gàobié	/to leave/
告狀	告狀	gàozhuàng	/to tell on sb/
胳膊	胳膊	gēbo	/arm/
歌唱	歌唱	gēchàng	/to sing/
歌手	歌手	gēshǒu	/singer/
歌頌	歌頌	gēsòng	/to sing the praises of/
疙瘩	疙瘩	gēda	/swelling or lump on skin/
鴿子	鴿子	gēzi	/pigeon/
隔閡	隔閡	géhé	/misunderstanding/
隔天	隔天	gétiān	/the next day/
格局	格局	géjú	/structure/
格式	格式	géshì	/form/
格外	格外	géwài	/especially/
革新	革新	géxīn	/to innovate/
各界	各界	gèjiè	/all walks of life/
各自	各自	gèzì	/each/
個數	個數	gèshù	/number of items or individuals/
個體	個體	gètǐ	/individual/
給予	給予	gěiyǔ	/to accord/
跟進	跟進	gēnjìn	/to follow/
跟前	跟前	gēnqián	/the front (of)/
根源	根源	gēnyuán	/origin/
耕地	耕地	gēngdì	/arable land/
更動	更動	gēngdòng	/to change/
弓	弓	gōng	/a bow (weapon)/
工地	工地	gōngdì	/construction site/
工讀	工讀	gōngdú	//
工藝品	工藝品	gōngyìpǐn	/handicraft article/
公安	公安	gōngān	/(Ministry of) Public Security/
公費	公費	gōngfèi	/at public expense/
公會	公會	gōnghuì	/guild/
公民	公民	gōngmín	/citizen/
公認	公認	gōngrèn	/publicly known (to be)/
公事	公事	gōngshì	/public affairs/
公文	公文	gōngwén	/document/
公務	公務	gōngwù	/official business/
公務員	公務員	gōngwùyuán	/functionary/
公益	公益	gōngyì	/public good/
公債	公債	gōngzhài	/government bond/
功勞	功勞	gōngláo	/contribution/
功利	功利	gōnglì	/utility/
攻	攻	gōng	/to attack/
攻讀	攻讀	gōngdú	/to major (in a field)/
攻擊	攻擊	gōngjí	/to attack/
供給	供給	gōnjǐ	/to furnish/
宮殿	宮殿	gōngdiàn	/palace/
恭敬	恭敬	gōngjìng	/deferential/
恭維	恭維	gōngwéi	/to praise/
鞏固	鞏固	gǒnggù	/to consolidate/
共產	共產	gòngchǎn	/communist/
共和國	共和國	gònghéguó	/republic/
共鳴	共鳴	gòngmíng	/resonance (physics)/
供養	供養	gòngyàng	/to supply/
勾結	勾結	gōujié	/to collude with/
構想	構想	gòuxiǎng	/to conceive/
孤獨	孤獨	gūdú	/lonely/
孤兒	孤兒	gūér	/orphan/
孤立	孤立	gūlì	/isolate/
辜負	辜負	gūfù	/to fail to live up (to expectations)/
估價	估價	gūjià	/to value/
古怪	古怪	gǔguài	/eccentric/
古跡	古跡	gǔjī	/places of historic interest/
古籍	古籍	gǔjí	/ancient text/
古物	古物	gǔwù	/antique/
股市	股市	gǔshì	/stock market/
鼓吹	鼓吹	gǔchuī	/to agitate for/
鼓動	鼓動	gǔdòng	/to agitate/
雇	雇	gù	/to employ/
固然	固然	gùrán	/admittedly (it's true that...)/
固體	固體	gùtǐ	/solid/
固有	固有	gùyǒu	/intrinsic to sth/
固執	固執	gùzhí	/obstinate/
顧全	顧全	gùquán	/to give careful consideration to/
蝸牛	蝸牛	guāniú	/snail/
寡婦	寡婦	guǎfù	/widow/
拐	拐	guǎi	/to turn (a corner etc)/
怪不得	怪不得	guàibùde	/no wonder!/
官司	官司	guānsi	/lawsuit/
棺材	棺材	guāncai	/coffin/
觀測	觀測	guāncè	/to observe/
觀感	觀感	guāngǎn	/one's impressions/
觀看	觀看	guānkàn	/to watch/
觀摩	觀摩	guānmó	/to observe and emulate/
觀望	觀望	guānwàng	/to wait and see/
關稅	關稅	guānshuì	/customs duty/
關切	關切	guānqiè	/to be deeply concerned/
關懷	關懷	guānhuái	/care/
關頭	關頭	guāntóu	/juncture/
關照	關照	guānzhào	/to take care/
管教	管教	guǎnjiào	/to discipline/
管線	管線	guǎnxiàn	/pipeline/
管子	管子	guǎnzi	/Guanzi or Guan Zhong 管仲 (-645 BC), famous politician of Qi 齊國|齐国 of Spring and Autumn period/
貫徹	貫徹	guànchè	/to implement/
灌	灌	guàn	/to irrigate/
灌溉	灌溉	guàngài	/to irrigate/
灌輸	灌輸	guànshū	/to imbue with/
光顧	光顧	guānggù	/to visit (as a customer)/
光滑	光滑	guānghuá	/glossy/
光輝	光輝	guānghuī	/radiance/
光芒	光芒	guāngmáng	/rays of light/
規範	規範	guīfàn	/norm/
規格	規格	guīgé	/standard/
歸	歸	guī	/to return/
歸還	歸還	guīhuán	/to return sth/
歸納	歸納	guīnà	/to sum up/
軌道	軌道	guǐdào	/orbit/
鬼怪	鬼怪	guǐguài	/hobgoblin/
貴賓	貴賓	guìbīn	/honored guest/
棍子	棍子	gùnzi	/stick/
國產	國產	guóchǎn	/made in one's own country/
國防	國防	guófáng	/national defense/
國境	國境	guójìng	/national border/
國君	國君	guójūn	/monarch/
國民	國民	guómín	/nationals/
國營	國營	guóyíng	/state-run (company etc)/
果斷	果斷	guǒduàn	/firm/
果實	果實	guǒshí	/fruit (produced by a plant)/
果樹	果樹	guǒshù	/fruit tree/
果真	果真	guǒzhēn	/really/
過關	過關	guòguān	/to cross a barrier/
過量	過量	guòliàng	/excess/
過敏	過敏	guòmǐn	/oversensitive/
過目	過目	guòmù	/to look over/
過人	過人	guòrén	/to surpass others/
過失	過失	guòshī	/error/
過癮	過癮	guòyǐn	/to satisfy a craving/
過重	過重	guòzhòng	/overweight (luggage)/
海拔	海拔	hǎibá	/height above sea level/
海面	海面	hǎimiàn	/sea level/
海嘯	海嘯	hǎixiào	/tsunami/
海運	海運	hǎiyùn	/shipping by sea/
害蟲	害蟲	hàichóng	/injurious insect/
行號	行號	hánghào	/(registered) company/
行列	行列	hángliè	/ranks/
航空信	航空信	hángkōngxìn	/airmail letter/
航行	航行	hángxíng	/to sail/
毫不	毫不	háobù	/hardly/
好比	好比	hǎobǐ	/to be just like/
好手	好手	hǎoshǒu	/expert/
好受	好受	hǎoshòu	/feeling better/
號子	號子	hàozi	/work chant/
合併	合併	hébìng	/to merge/
合同	合同	hétong	/(business) contract/
合意	合意	héyì	/to suit one's taste/
合約	合約	héyuē	/treaty/
何在	何在	hézài	/where?/
和解	和解	héjiě	/to settle (a dispute out of court)/
和睦	和睦	hémù	/peaceful relations/
和諧	和諧	héxié	/harmonious/
核定	核定	hédìng	/to audit and determine/
核對	核對	héduì	/to check/
核算	核算	hésuàn	/to calculate/
核准	核准	hézhǔn	/to authorize/
核子	核子	hézǐ	/nuclear/
黑名單	黑名單	hēimíngdān	/blacklist/
黑社會	黑社會	hēishèhuì	/criminal underworld/
狠	狠	hěn	/ruthless/
狠心	狠心	hěnxīn	/callous/
哼	哼	hēng	/to groan/
衡量	衡量	héngliáng	/to weigh/
轟動	轟動	hōngdòng	/to cause a sensation/
轟轟烈烈	轟轟烈烈	hōnghōnglièliè	/strong/
紅利	紅利	hónglì	/bonus/
紅燒	紅燒	hóngshāo	/simmer-fried (dish)/
洪水	洪水	hóngshuǐ	/deluge/
宏偉	宏偉	hóngwěi	/grand/
哄	哄	hǒng	/tumult/
後輩	後輩	hòubèi	/younger generation/
候選人	候選人	hòuxuǎnrén	/candidate/
呼籲	呼籲	hūyù	/to call on (sb to do sth)/
壺	壺	hú	/pot/
胡亂	胡亂	húluàn	/careless/
狐疑	狐疑	húyí	/suspicious/
戶口	戶口	hùkǒu	/population (counted as number of households for census or taxation)/
互補	互補	hùbǔ	/complementary/
互動	互動	hùdòng	/to interact/
互惠	互惠	hùhuì	/mutual benefit/
花瓣	花瓣	huābàn	/petal/
花朵	花朵	huāduǒ	/flower/
花卉	花卉	huāhuì	/flowers and plants/
花紋	花紋	huāwén	/decorative design/
花樣	花樣	huāyàng	/pattern/
划不來	划不來	huábùlái	/not worth it/
划得來	划得來	huádelái	/worth it/
華裔	華裔	huáyì	/ethnic Chinese/
化工	化工	huàgōng	/chemical industry, abbr. of 化學工業|化学工业[hua4 xue2 gong1 ye4]/
化石	化石	huàshí	/fossil/
話劇	話劇	huàjù	/stage play/
畫面	畫面	huàmiàn	/scene/
畫展	畫展	huàzhǎn	/art exhibition/
劃時代	劃時代	huàshídài	/epoch-marking/
懷疑	懷疑	huáiyí	/to doubt (sth)/
歡送	歡送	huānsòng	/to see off/
幻象	幻象	huànxiàng	/illusion/
換取	換取	huànqǔ	/to obtain (sth) in exchange/
患	患	huàn	/to suffer (from illness)/
患者	患者	huànzhě	/patient/
荒唐	荒唐	huāngtáng	/beyond belief/
慌張	慌張	huāngzhāng	/confused/
惶恐	惶恐	huángkǒng	/terrified/
恍惚	恍惚	huǎnghū	/absent-minded/
灰塵	灰塵	huīchén	/dust/
輝煌	輝煌	huīhuáng	/splendid/
回合	回合	huíhé	/one of a sequence of contests (or subdivisions of a contest) between the same two opponents/
回絕	回絕	huíjué	/to rebuff/
回升	回升	huíshēng	/to rise again after a fall/
迴	迴	huíxiǎng	/to curve/
毀損	毀損	huǐsǔn	/impair, damage/
悔恨	悔恨	huǐhèn	/remorse/
匯票	匯票	huìpiào	/bill of exchange/
會見	會見	huìjiàn	/to meet with (sb who is paying a visit)/
會談	會談	huìtán	/talks/
會意	會意	huìyì	/combined ideogram (one of the Six Methods 六書|六书[liu4 shu1] of forming Chinese characters)/
繪畫	繪畫	huìhuà	/drawing/
賄賂	賄賂	huìlù	/to bribe/
彗星	彗星	huìxīng	/comet/
渾身	渾身	húnshēn	/all over/
混淆	混淆	hùnyáo	/to obscure/
混濁	混濁	hùnzhuó	/turbid/
活期	活期	huóqí	/(banking) current (account)/
火箭	火箭	huǒjiàn	/rocket/
火力	火力	huǒlì	/fire/
火焰	火焰	huǒyàn	/blaze/
火藥	火藥	huǒyào	/gunpowder/
伙伴	伙伴	huǒbàn	/partner/
貨幣	貨幣	huòbì	/currency/
貨品	貨品	huòpǐn	/goods/
豁達	豁達	huòdá	/optimistic/
基層	基層	jīcéng	/basic level/
基地	基地	jīdì	/base (of operations)/
基督	基督	jīdū	/Christ/
基因	基因	jīyīn	/gene (loanword)/
機動	機動	jīdòng	/locomotive/
機警	機警	jījǐng	/perceptive/
機率	機率	jīlǜ	/probability/
機密	機密	jīmì	/secret/
機器人	機器人	jīqìrén	/mechanical person/
機制	機制	jīzhì	/mechanism/
肌膚	肌膚	jīfū	/skin/
飢餓	飢餓	jīè	/hunger/
畸形	畸形	jīxíng	/deformity/
激增	激增	jīzēng	/to increase rapidly/
及早	及早	jízǎo	/at the earliest possible time/
吉利	吉利	jílì	/Geely, Chinese car make/
吉祥	吉祥	jíxiáng	/lucky/
汲取	汲取	jíqǔ	/to draw/
即日	即日	jírì	/this or that very day/
即時	即時	jíshí	/immediate/
嫉妒	嫉妒	jídù	/to be jealous/
極端	極端	jíduān	/extreme/
極力	極力	jílì	/to make a supreme effort/
極為	極為	jíwéi	/extremely/
集結	集結	jíjié	/to assemble/
集權	集權	jíquán	/centralized power (history), e.g. under an Emperor or party/
集體	集體	jítǐ	/collective (decision)/
集團	集團	jítuán	/group/
急救	急救	jíjiù	/first aid/
急躁	急躁	jízào	/irritable/
急診	急診	jízhěn	/emergency call/
籍貫	籍貫	jíguàn	/one's native place/
擊落	擊落	jíluò	/to shoot down (a plane)/
暨	暨	jì	/and/
繼承	繼承	jìchéng	/to inherit/
季風	季風	jìfēng	/monsoon/
劑量	劑量	jìliàng	/dosage/
紀律	紀律	jìlǜ	/discipline/
技能	技能	jìnéng	/technical ability/
技藝	技藝	jìyì	/skill/
祭祀	祭祀	jìsì	/to offer sacrifices to the gods or ancestors/
傢伙	傢伙	jiāhuo	/household dish, implement or furniture/
家家戶戶	家家戶戶	jiājiāhùhù	/each and every family (idiom)/
家電	家電	jiādiàn	/household electric appliance/
家屬	家屬	jiāshǔ	/family member/
佳節	佳節	jiājié	/festive day/
佳人	佳人	jiārén	/beautiful woman/
加緊	加緊	jiājǐn	/to intensify/
加快	加快	jiākuài	/to accelerate/
加薪	加薪	jiāxīn	/to raise salary/
加重	加重	jiāzhòng	/to make heavier/
枷鎖	枷鎖	jiāsuǒ	/stocks and chain/
夾雜	夾雜	jiázá	/to mix together (disparate substances)/
假若	假若	jiǎruò	/if/
假使	假使	jiǎshǐ	/if/
假象	假象	jiǎxiàng	/false appearance/
架構	架構	jiàgòu	/to construct/
假期	假期	jiàqí	/vacation/
煎	煎	jiān	/to pan fry/
監督	監督	jiāndū	/to control/
尖端	尖端	jiānduān	/sharp pointed end/
堅固	堅固	jiāngù	/firm/
堅忍	堅忍	jiānrěn	/persevering/
堅信	堅信	jiānxìn	/to believe firmly/
堅硬	堅硬	jiānyìng	/hard/
兼職	兼職	jiānzhí	/to hold concurrent posts/
艱鉅	艱鉅	jiānjù	//
艱苦	艱苦	jiānkǔ	/difficult/
艱難	艱難	jiānnán	/difficult/
簡便	簡便	jiǎnbiàn	/simple and convenient/
簡稱	簡稱	jiǎnchēng	/to be abbreviated to/
簡化	簡化	jiǎnhuà	/to simplify/
簡體	簡體	jiǎntǐ	/simplified form of Chinese characters, as opposed to traditional form 繁體|繁体[fan2 ti3]/
檢討	檢討	jiǎntǎo	/to examine or inspect/
賤	賤	jiàn	/inexpensive/
濺	濺	jiàn	/to splash/
見解	見解	jiànjiě	/opinion/
見識	見識	jiànshì	/to gain first-hand knowledge of sth/
見證	見證	jiànzheng	/to be witness to/
建造	建造	jiànzào	/to construct/
健身	健身	jiànshēn	/to exercise/
健身房	健身房	jiànshēnfáng	/gym/
健壯	健壯	jiànzhuàng	/robust/
將軍	將軍	jiāngjūn	/general/
獎勵	獎勵	jiǎnglì	/to reward/
獎賞	獎賞	jiǎngshǎng	/reward/
獎狀	獎狀	jiǎngzhuàng	/prize certificate/
講理	講理	jiǎnglǐ	/to argue/
講習	講習	jiǎngxí	/to lecture/
講義	講義	jiǎngyì	/teaching materials/
講座	講座	jiǎngzuò	/a course of lectures/
交錯	交錯	jiāocuò	/to crisscross/
交貨	交貨	jiāohuò	/to deliver goods/
交集	交集	jiāojí	/intersection (symbol ∩) (set theory)/
交情	交情	jiāoqíng	/friendship/
交涉	交涉	jiāoshè	/to negotiate (with)/
交談	交談	jiāotán	/to discuss/
焦急	焦急	jiāojí	/anxiety/
腳本	腳本	jiǎoběn	/script/
攪和	攪和	jiǎohuo	/to mix (up)/
轎車	轎車	jiàochē	/enclosed carriage for carrying passengers/
叫好	叫好	jiàohǎo	/to applaud/
教官	教官	jiàoguān	/military instructor/
教化	教化	jiàohuà	/to enlighten/
教誨	教誨	jiàohuǐ	/to instruct/
教徒	教徒	jiàotú	/disciple/
教員	教員	jiàoyuán	/teacher/
較量	較量	jiàoliàng	/to pit oneself against sb/
皆	皆	jiē	/all/
階層	階層	jiēcéng	/hierarchy/
階級	階級	jiējí	/(social) class/
街坊	街坊	jiēfang	/neighborhood/
接管	接管	jiēguǎn	/to take over/
接連	接連	jiēlián	/on end/
接納	接納	jiēnà	/to admit (to membership)/
接洽	接洽	jiēqià	/to discuss a matter with sb/
接下來	接下來	jiēxiàlái	/to accept/
揭幕	揭幕	jiēmù	/opening/
揭曉	揭曉	jiēxiǎo	/to announce publicly/
潔白	潔白	jiébái	/spotlessly white/
節儉	節儉	jiéjiǎn	/frugal/
節慶	節慶	jiéqìng	/festival/
竭力	竭力	jiélì	/to do one's utmost/
結實	結實	jiéshi	/to bear fruit/
結業	結業	jiéyè	/to finish school, esp. a short course/
結緣	結緣	jiéyuán	/to form ties/
捷運	捷運	jiéyùn	/rapid transit/
解放	解放	jiěfàng	/to liberate/
解渴	解渴	jiěkě	/to quench/
解剖	解剖	jiěpǒu	/to dissect (an animal)/
解說	解說	jiěshuō	/to explain/
解體	解體	jiětǐ	/to break up into components/
解脫	解脫	jiětuō	/to untie/
解約	解約	jiěyuē	/to terminate an agreement/
屆時	屆時	jièshí	/when the time comes/
戒備	戒備	jièbèi	/to take precautions/
借貸	借貸	jièdài	/to borrow or lend money/
藉口	藉口	jièkǒu	/to use as an excuse/
介入	介入	jièrù	/to intervene/
金錢	金錢	jīnqián	/money/
金魚	金魚	jīnyú	/goldfish/
津貼	津貼	jīntiē	/allowance/
緊湊	緊湊	jǐncòu	/compact/
緊密	緊密	jǐnmì	/inseparably close/
緊縮	緊縮	jǐnsuō	/(economics) to reduce/
謹慎	謹慎	jǐnshèn	/cautious/
勁	勁	jìn	/strength/
進場	進場	jìnchǎng	/to go into/
進度	進度	jìndù	/pace/
進而	進而	jìnér	/and then (what follows next)/
進攻	進攻	jìngōng	/to attack/
進化	進化	jìnhuà	/evolution/
進軍	進軍	jìnjūn	/to march/
進修	進修	jìnxiū	/to undertake advanced studies/
進展	進展	jìnzhǎn	/to make headway/
晉級	晉級	jìnjí	/to advance in rank/
盡量	盡量	jìnliàng	/as much as possible/
禁令	禁令	jìnlìng	/prohibition/
精光	精光	jīngguāng	/nothing left (money, food etc)/
精華	精華	jīnghuá	/best feature/
精明	精明	jīngmíng	/astute/
精髓	精髓	jīngsuǐ	/marrow/
精緻	精緻	jīngzhì	/delicate/
經典	經典	jīngdiǎn	/the classics/
經書	經書	jīngshū	/classic books in Confucianism/
驚惶	驚惶	jīnghuáng	/panic-stricken/
驚奇	驚奇	jīngqí	/to be amazed/
驚喜	驚喜	jīngxǐ	/nice surprise/
驚險	驚險	jīngxiǎn	/thrilling/
鯨魚	鯨魚	jīngyú	/whale/
井	井	jǐng	/Jing, one of the 28 constellations of Chinese astronomy/
警報	警報	jǐngbào	/(fire) alarm/
警覺	警覺	jǐngjué	/to be on guard/
警惕	警惕	jǐngtì	/to be on the alert/
警衛	警衛	jǐngwèi	/to stand guard over/
景觀	景觀	jǐngguān	/landscape/
景氣	景氣	jǐngqì	/(of economy, business etc) flourishing/
景物	景物	jǐngwù	/scenery/
景象	景象	jǐngxiàng	/scene/
敬佩	敬佩	jìngpèi	/to esteem/
境地	境地	jìngdì	/circumstances/
靜脈	靜脈	jìngmài	/vein/
靜態	靜態	jìngtài	/static/
競賽	競賽	jìngsài	/race/
競選	競選	jìngxuǎn	/to take part in an election/
揪	揪	jiū	/to seize/
糾紛	糾紛	jiūfēn	/dispute/
酒店	酒店	jiǔdiàn	/wine shop/
酒館	酒館	jiǔguǎn	/tavern/
酒精	酒精	jiǔjīng	/alcohol/
就緒	就緒	jiùxù	/to be ready/
救濟	救濟	jiùjì	/emergency relief/
救援	救援	jiùyuán	/to save/
局部	局部	júbù	/part/
局面	局面	júmiàn	/aspect/
沮喪	沮喪	jǔsàng	/dispirited/
舉例	舉例	jǔlì	/to give an example/
舉止	舉止	jǔzhǐ	/bearing/
舉重	舉重	jǔzhòng	/to lift weights/
巨人	巨人	jùrén	/giant/
據悉	據悉	jùxī	/according to reports/
聚餐	聚餐	jùcān	/communal meal/
俱全	俱全	jùquán	/every kind/
捐獻	捐獻	juānxiàn	/to donate/
捐贈	捐贈	juānzèng	/to contribute (as a gift)/
決賽	決賽	juésài	/finals (of a competition)/
決議	決議	juéyì	/resolution/
抉擇	抉擇	juézé	/to choose (literary)/
絕大多數	絕大多數	juédàduōshù	/absolute majority/
絕跡	絕跡	juéjī	/to be eradicated/
均衡	均衡	jūnhéng	/equal/
均勻	均勻	jūnyún	/even/
軍備	軍備	jūnbèi	/(military) arms/
軍閥	軍閥	jūnfá	/military clique/
軍官	軍官	jūnguān	/officer (military)/
軍艦	軍艦	jūnjiàn	/warship/
開辦	開辦	kāibàn	/to open/
開導	開導	kāidǎo	/to talk sb round/
開動	開動	kāidòng	/to start/
開飯	開飯	kāifàn	/to serve a meal/
開口	開口	kāikǒu	/to open one's mouth/
開闊	開闊	kāikuò	/wide/
開路	開路	kāilù	/to open up a path/
開幕	開幕	kāimù	/to open (a conference)/
開盤	開盤	kāipán	/to commence trading (stock market)/
開闢	開闢	kāipì	/to open up/
開啟	開啟	kāiqǐ	/to open/
開頭	開頭	kāitóu	/beginning/
開銷	開銷	kāixiāo	/to pay (expenses)/
開業	開業	kāiyè	/to open a business/
開展	開展	kāizhǎn	/to launch/
開張	開張	kāizhāng	/to open a business/
刊物	刊物	kānwù	/publication/
刊登	刊登	kāndēng	/to carry a story/
看守	看守	kānshǒu	/to guard/
康復	康復	kāngfù	/to recuperate/
慷慨	慷慨	kāngkǎi	/vehement/
扛	扛	káng	/old variant of 扛[gang1]/
抗爭	抗爭	kàngzhēng	/to resist/
考場	考場	kǎochǎng	/exam room/
考古	考古	kǎogǔ	/archaeology/
考量	考量	kǎoliáng	/to consider/
考生	考生	kǎoshēng	/exam candidate/
考驗	考驗	kǎoyàn	/to test/
烤肉	烤肉	kǎoròu	/barbecue (lit. roast meat)/
刻畫	刻畫	kèhuà	/to portray/
科幻	科幻	kēhuàn	/science fiction/
苛責	苛責	kēzé	/to criticize harshly/
可觀	可觀	kěguān	/considerable/
可見	可見	kějiàn	/it can clearly be seen (that this is the case)/
可望	可望	kěwàng	/can be expected (to)/
可行	可行	kěxíng	/feasible/
刻薄	刻薄	kèbó	/unkind/
刻苦	刻苦	kèkǔ	/hardworking/
刻意	刻意	kèyì	/meticulous/
客機	客機	kèjī	/passenger plane/
課業	課業	kèyè	/lesson/
克制	克制	kèzhì	/to restrain/
吭聲	吭聲	kēngshēng	/to utter a word/
空曠	空曠	kōngkuàng	/spacious and empty/
空難	空難	kōngnàn	/air crash/
空談	空談	kōngtán	/prattle/
空運	空運	kōngyùn	/air transport/
恐嚇	恐嚇	kǒnghè	/to threaten/
恐懼	恐懼	kǒngjù	/to be frightened/
口頭	口頭	kǒutóu	/oral/
口吻	口吻	kǒuwěn	/tone of voice/
扣除	扣除	kòuchú	/to deduct/
苦工	苦工	kǔgōng	/hard labor (in penal code)/
苦難	苦難	kǔnàn	/suffering/
苦惱	苦惱	kǔnǎo	/vexed/
苦衷	苦衷	kǔzhōng	/secret trouble/
庫存	庫存	kùcún	/property or cash held in reserve/
誇耀	誇耀	kuāyào	/to brag about/
跨越	跨越	kuàyuè	/to step across/
快活	快活	kuàihuo	/happy/
快速	快速	kuàisù	/fast/
寬廣	寬廣	kuānguǎng	/wide/
寬闊	寬闊	kuānkuò	/expansive/
款待	款待	kuǎndài	/to entertain/
款式	款式	kuǎnshì	/pattern/
狂風	狂風	kuángfēng	/gale/
狂妄	狂妄	kuángwàng	/egotistical/
礦產	礦產	kuàngchǎn	/minerals/
礦工	礦工	kuànggōng	/miner/
昆蟲	昆蟲	kūnchóng	/insect/
捆	捆	kǔn	/variant of 捆[kun3]/
困境	困境	kùnjìng	/predicament/
困擾	困擾	kùnrǎo	/to perplex/
擴建	擴建	kuòjiàn	/to extend (a building, an airport runway etc)/
擴散	擴散	kuòsàn	/to spread/
擴張	擴張	kuòzhāng	/expansion/
拉票	拉票	lāpiào	/to campaign for votes/
臘月	臘月	làyuè	/twelfth lunar month/
來賓	來賓	láibīn	/guest/
來得	來得	láide	/to emerge (from a comparison)/
來客	來客	láikè	/guest/
欄	欄	lán	/fence/
攔	攔	lán	/to block sb's path/
懶惰	懶惰	lǎnduò	/idle/
懶散	懶散	lǎnsǎn	/inactive/
朗讀	朗讀	lǎngdú	/to read aloud/
朗誦	朗誦	lǎngsòng	/to read aloud with expression/
勞改	勞改	láogǎi	/reform through labor/
勞累	勞累	láolèi	/tired/
老年	老年	lǎonián	/elderly/
老人家	老人家	lǎorenjia	/polite term for old woman or man/
老鼠	老鼠	lǎoshǔ	/rat/
老天爺	老天爺	lǎotiānyé	/God/
老頭兒	老頭兒	lǎotóur	/see 老頭子|老头子[lao3 tou2 zi5]/
老鄉	老鄉	lǎoxiāng	/fellow townsman/
老子	老子	lǎozi	/Laozi or Lao-tze (c. 500 BC), Chinese philosopher, the founder of Taoism/
雷	雷	léi	/thunder/
雷達	雷達	léidá	/radar (loanword)/
雷同	雷同	léitóng	/mirroring others/
累積	累積	lěijī	/to accumulate/
類型	類型	lèixíng	/type/
冷凍	冷凍	lěngdòng	/to freeze/
冷汗	冷汗	lěnghàn	/cold sweat/
冷門	冷門	lěngmén	/a neglected branch (of arts, science, sports etc)/
冷清	冷清	lěngqīng	/cold and cheerless/
勒索	勒索	lèsuǒ	/to blackmail/
哩	哩	lī	/mile (unit of length equal to 1,609.344 m)/
黎明	黎明	límíng	/dawn/
罹難	罹難	línàn	/to die in an accident or disaster/
里程	里程	lǐchéng	/mileage (distance traveled)/
理財	理財	lǐcái	/financial management/
理所當然	理所當然	lǐsuǒdāngrán	/as it should be by rights (idiom); proper and to be expected as a matter of course/
理性	理性	lǐxìng	/reason/
理學	理學	lǐxué	/School of Principle/
理智	理智	lǐzhì	/reason/
禮服	禮服	lǐfú	/ceremonial robe/
禮節	禮節	lǐjié	/etiquette/
力求	力求	lìqiú	/to make every effort to/
力行	力行	lìxíng	/to practice diligently/
力學	力學	lìxué	/mechanics/
立國	立國	lìguó	/to found a country/
立體	立體	lìtǐ	/three-dimensional/
利率	利率	lìlǜ	/interest rates/
利弊	利弊	lìbì	/pros and cons/
歷屆	歷屆	lìjiè	/all previous (meetings, sessions etc)/
歷來	歷來	lìlái	/always/
歷年	歷年	lìnián	/over the years/
聯盟	聯盟	liánméng	/alliance/
聯繫	聯繫	liánxì	/connection/
聯想	聯想	liánxiǎng	/to associate (cognitively)/
連帶	連帶	liándài	/to be related/
連結	連結	liánjié	/variant of 聯結|联结[lian2 jie2]/
連任	連任	liánrèn	/to continue in (a political) office/
連線	連線	liánxiàn	/electrical lead/
廉價	廉價	liánjià	/cheaply-priced/
廉潔	廉潔	liánjié	/honest/
臉龐	臉龐	liǎnpáng	/face/
臉譜	臉譜	liǎnpǔ	/Facebook/
良機	良機	liángjī	/a good chance/
兩極	兩極	liǎngjí	/the two poles/
兩口子	兩口子	liǎngkǒuzi	/husband and wife/
遼闊	遼闊	liáokuò	/vast/
列車	列車	lièchē	/(railway) train/
列國	列國	lièguó	/various countries/
列入	列入	lièrù	/to include on a list/
獵人	獵人	lièrén	/hunter/
烈士	烈士	lièshì	/martyr/
臨床	臨床	línchuáng	/clinical/
鄰里	鄰里	línlǐ	/neighbor/
鈴	鈴	líng	/(small) bell/
靈感	靈感	línggǎn	/inspiration/
靈驗	靈驗	língyàn	/efficacious/
領隊	領隊	lǐngduì	/to lead a group/
領會	領會	lǐnghuì	/to understand/
領悟	領悟	lǐngwù	/to understand/
溜冰	溜冰	liūbīng	/ice skating/
流程	流程	liúchéng	/course/
流傳	流傳	liúchuán	/to spread/
流落	流落	liúluò	/to wander about destitute/
流氓	流氓	liúmáng	/rogue/
流失	流失	liúshī	/drainage/
流水	流水	liúshuǐ	/running water/
流通	流通	liútōng	/to circulate/
流星	流星	liúxīng	/meteor/
流域	流域	liúyù	/river basin/
柳樹	柳樹	liǔshù	/willow/
籠子	籠子	lóngzi	/cage/
籠罩	籠罩	lóngzhào	/to envelop/
壟斷	壟斷	lǒngduàn	/to enjoy market dominance/
樓房	樓房	lóufáng	/a building of two or more stories/
漏	漏	lòu	/to leak/
爐子	爐子	lúzi	/stove/
陸地	陸地	lùdì	/dry land (as opposed to the sea)/
路過	路過	lùguò	/to pass by or through/
露天	露天	lùtiān	/outdoors/
錄影	錄影	lùyǐng	/to videotape/
錄影機	錄影機	lùyǐngjī	/camcorder/
輪廓	輪廓	lúnkuò	/an outline/
倫理	倫理	lúnlǐ	/ethics/
淪陷	淪陷	lúnxiàn	/to fall into enemy hands/
論點	論點	lùndiǎn	/argument/
卵	卵	luǎn	/egg/
囉嗦	囉嗦	luōsuo	/long-winded/
鑼	鑼	luó	/gong/
邏輯	邏輯	luójí	/logic (loanword)/
落得	落得	luòdé	/ending up as/
落魄	落魄	luòtuò	/down and out/
落選	落選	luòxuǎn	/to fail to be chosen (or elected)/
駱駝	駱駝	luòtuo	/camel/
驢	驢	lǘ	/donkey/
鋁	鋁	lǚ	/aluminum (chemistry)/
旅費	旅費	lǚfèi	/travel expenses/
旅途	旅途	lǚtú	/journey/
履歷	履歷	lǚlì	/background (academic and work)/
履行	履行	lǚxíng	/to fulfill (one's obligations)/
麻醉	麻醉	mázuì	/anesthesia/
馬鈴薯	馬鈴薯	mǎlíngshǔ	/potato/
埋伏	埋伏	máifú	/to ambush/
買主	買主	mǎizhǔ	/customer/
邁	邁	mài	/to take a step/
邁進	邁進	màijìn	/to step in/
麥子	麥子	màizi	/wheat/
賣座	賣座	màizuò	/(of a movie, show etc) to attract large audiences/
瞞	瞞	mán	/to conceal from/
蠻橫	蠻橫	mánhèng	/rude and unreasonable/
滿懷	滿懷	mǎnhuái	/to have one's heart filled with/
漫長	漫長	màncháng	/very long/
蔓延	蔓延	mànyán	/to extend/
盲從	盲從	mángcóng	/to follow blindly/
盲人	盲人	mángrén	/blind person/
芒果	芒果	mángguǒ	/mango/
茫然	茫然	mángrán	/blankly/
毛毯	毛毯	máotǎn	/blanket/
茂密	茂密	màomì	/dense (of plant growth)/
冒險	冒險	màoxiǎn	/to take risks/
枚	枚	méi	/classifier for coins, rings, badges, pearls, sporting medals, rockets, satellites etc/
眉毛	眉毛	méimao	/eyebrow/
眉頭	眉頭	méitóu	/brows/
媒體	媒體	méitǐ	/media, esp. news media/
每每	每每	měiměi	/often/
美滿	美滿	měimǎn	/happy/
美容院	美容院	měiróngyuàn	/beauty salon/
美食	美食	měishí	/culinary delicacy/
美洲	美洲	měizhōu	/America (including North, Central and South America)/
悶	悶	mēn	/stuffy/
悶熱	悶熱	mēnrè	/sultry/
門戶	門戶	ménhù	/door/
蒙	蒙	méng	/to deceive/
猛烈	猛烈	měngliè	/fierce/
夢見	夢見	mèngjiàn	/to dream about (sth or sb)/
謎	謎	mí	/riddle/
謎語	謎語	míyǔ	/riddle/
迷宮	迷宮	mígōng	/maze/
迷惑	迷惑	míhuò	/to puzzle/
迷戀	迷戀	míliàn	/to be infatuated with/
彌補	彌補	míbǔ	/to complement/
密集	密集	mìjí	/concentrated/
明理	明理	mínglǐ	/sensible/
明日	明日	míngrì	/tomorrow/
明智	明智	míngzhì	/sensible/
名額	名額	míngé	/quota/
名號	名號	mínghào	/name/
名氣	名氣	míngqì	/reputation/
名勝	名勝	míngshèng	/a place famous for its scenery or historical relics/
名聲	名聲	míngshēng	/reputation/
名堂	名堂	míngtáng	/item (in a program of entertainments)/
名下	名下	míngxià	/under sb's name/
冥想	冥想	míngxiǎng	/to meditate/
命名	命名	mìngmíng	/to give a name to/
命中	命中	mìngzhòng	/to hit (a target)/
綿延	綿延	miányán	/continuous (esp. of mountain ranges)/
免稅	免稅	miǎnshuì	/not liable to taxation (of monastery, imperial family etc)/
免疫	免疫	miǎnyì	/immunity (to disease)/
面孔	面孔	miànkǒng	/face/
面談	面談	miàntán	/face-to-face meeting/
描繪	描繪	miáohuì	/to describe/
描述	描述	miáoshù	/to describe/
民俗	民俗	mínsú	/popular custom/
民營	民營	mínyíng	/privately run (i.e. by a company, not the state)/
敏感	敏感	mǐngǎn	/sensitive/
敏捷	敏捷	mǐnjié	/nimble/
模範	模範	mófàn	/model/
模具	模具	mójù	/mold/
模式	模式	móshì	/mode/
魔術	魔術	móshù	/magic/
末期	末期	mòqí	/end (of a period)/
墨	墨	mò	/ink stick/
沒落	沒落	mòluò	/to decline/
沒收	沒收	mòshōu	/to confiscate/
默默	默默	mòmò	/in silence/
默契	默契	mòqì	/tacit understanding/
漠視	漠視	mòshì	/to ignore/
謀生	謀生	móushēng	/to seek one's livelihood/
某些	某些	mǒuxiē	/some/
畝	畝	mǔ	/classifier for fields/
母語	母語	mǔyǔ	/native language/
木材	木材	mùcái	/wood/
木刻	木刻	mùkē	/woodcut/
木料	木料	mùliào	/lumber/
木偶	木偶	mùǒu	/puppet/
沐浴	沐浴	mùyù	/to take a bath/
目睹	目睹	mùdǔ	/to witness/
目光	目光	mùguāng	/sight/
目擊	目擊	mùjí	/to see with one's own eyes/
牧場	牧場	mùchǎng	/pasture/
募集	募集	mùjí	/to raise/
納悶	納悶	nàmèn	/puzzled/
納入	納入	nàrù	/to bring into/
納稅	納稅	nàshuì	/to pay taxes/
乃	乃	nǎi	/variant of 乃[nai3]/
耐力	耐力	nàilì	/endurance/
男方	男方	nánfāng	/the bridegroom's side/
南極洲	南極洲	nánjízhōu	/Antarctica/
難度	難度	nándù	/trouble/
難關	難關	nánguān	/difficulty/
難免	難免	nánmiǎn	/hard to avoid/
難題	難題	nántí	/difficult problem/
難民	難民	nànmín	/refugee/
囊括	囊括	nángguā	/to include/
腦海	腦海	nǎohǎi	/the mind/
腦力	腦力	nǎolì	/mental capacity/
內閣	內閣	nèigé	/(government) cabinet/
內涵	內涵	nèihán	/meaningful content/
內銷	內銷	nèixiāo	/to sell in the domestic market/
內在	內在	nèizài	/inner/
內戰	內戰	nèizhàn	/civil war/
內政	內政	nèizhèng	/internal affairs (of a country)/
能量	能量	néngliàng	/energy/
擬定	擬定	nǐdìng	/to draw up/
念頭	念頭	niàntou	/thought/
娘家	娘家	niángjia	/married woman's parents' home/
凝固	凝固	nínggù	/to freeze/
凝結	凝結	níngjié	/to condense/
凝聚	凝聚	níngjù	/to condense/
凝視	凝視	níngshì	/to gaze at/
扭轉	扭轉	niǔzhuǎn	/to reverse/
農具	農具	nóngjù	/farm implements/
農田	農田	nóngtián	/farmland/
農作物	農作物	nóngzuòwù	/(farm) crops/
弄錯	弄錯	nòngcuò	/to err/
奴隸	奴隸	núlì	/slave/
怒氣	怒氣	nùqì	/anger/
挪	挪	nuó	/to shift/
懦弱	懦弱	nuòruò	/cowardly/
諾言	諾言	nuòyán	/promise/
女方	女方	nǚfāng	/the bride's side (of a wedding)/
虐待	虐待	nüèdài	/to mistreat/
歐洲	歐洲	ōuzhōu	/Europe/
偶而	偶而	ǒuér	/occasionally/
趴	趴	pā	/to lie on one's stomach/
拍馬屁	拍馬屁	pāimǎpì	/to flatter/
拍攝	拍攝	pāishè	/to film/
拍照	拍照	pāizhào	/to take a picture/
拍子	拍子	pāizi	/beat (music)/
排除	排除	páichú	/to eliminate/
排擠	排擠	páijǐ	/to crowd out/
排名	排名	páimíng	/to rank (1st, 2nd etc)/
派出所	派出所	pàichūsuǒ	/local police station/
派對	派對	pàiduì	/party (loanword)/
派遣	派遣	pàiqiǎn	/to send (on a mission)/
派頭	派頭	pàitóu	/manner/
旁人	旁人	pángrén	/other people/
旁聽	旁聽	pángtīng	/to visit (a meeting, class, trial etc)/
拋	拋	pāo	/to throw/
拋棄	拋棄	pāoqì	/to abandon/
跑道	跑道	pǎodào	/athletic track/
泡沫	泡沫	pàomò	/foam/
陪伴	陪伴	péibàn	/to accompany/
培訓	培訓	péixùn	/to cultivate/
培育	培育	péiyù	/to train/
配給	配給	pèijǐ	/to ration/
配音	配音	pèiyīn	/dubbing (filmmaking)/
噴漆	噴漆	pēnqī	/to spray paint or lacquer/
盆地	盆地	péndì	/(geography) basin/
蓬勃	蓬勃	péngbó	/vigorous/
捧場	捧場	pěngchǎng	/to cheer on (originally esp. as paid stooge)/
批發	批發	pīfā	/wholesale/
批准	批准	pīzhǔn	/to approve/
疲憊	疲憊	píbèi	/beaten/
譬如	譬如	pìrú	/for example/
偏差	偏差	piānchā	/bias/
片刻	片刻	piànkè	/short period of time/
貧苦	貧苦	pínkǔ	/poverty-stricken/
貧民	貧民	pínmín	/poor people/
品味	品味	pǐnwèi	/to sample/
品種	品種	pǐnzhǒng	/breed/
乒乓球	乒乓球	pīngpāngqiú	/table tennis/
平凡	平凡	píngfán	/commonplace/
平面	平面	píngmiàn	/plane (flat surface)/
平穩	平穩	píngwěn	/smooth/
平行	平行	píngxíng	/parallel/
評估	評估	pínggū	/to evaluate/
評價	評價	píngjià	/to evaluate/
評論	評論	pínglùn	/to comment on/
婆家	婆家	pójiā	/husband's family/
破案	破案	pòàn	/to solve a case/
破產	破產	pòchǎn	/to go bankrupt/
破除	破除	pòchú	/to eliminate/
破獲	破獲	pòhuò	/to uncover (a criminal plot)/
破例	破例	pòlì	/to make an exception/
破碎	破碎	pòsuì	/to smash to pieces/
迫害	迫害	pòhài	/to persecute/
魄力	魄力	pòlì	/courage/
樸素	樸素	púsù	/plain and simple/
曝光	曝光	pùguāng	/to expose (photography)/
暴露	暴露	pùlù	/to expose/
淒涼	淒涼	qīliáng	/desolate (place)/
欺侮	欺侮	qīwǔ	/to bully/
奇觀	奇觀	qíguān	/spectacle/
奇蹟	奇蹟	qíjī	//
奇妙	奇妙	qímiào	/fantastic/
奇異	奇異	qíyì	/fantastic/
期待	期待	qídài	/to look forward to/
期貨	期貨	qíhuò	/abbr. for 期貨合約|期货合约[qi1 huo4 he2 yue1], futures contract (finance)/
期望	期望	qíwàng	/to have expectations/
旗幟	旗幟	qízhì	/ensign/
乞丐	乞丐	qǐgài	/beggar/
啟發	啟發	qǐfā	/to enlighten/
啟示	啟示	qǐshì	/to reveal/
啟事	啟事	qǐshì	/announcement (written, on billboard, letter, newspaper or website)/
起步	起步	qǐbù	/to set out/
起伏	起伏	qǐfú	/to move up and down/
起碼	起碼	qǐmǎ	/at the minimum/
起源	起源	qǐyuán	/origin/
氣概	氣概	qìgài	/lofty quality/
氣管	氣管	qìguǎn	/windpipe/
氣派	氣派	qìpai	/imposing manner or style/
氣勢	氣勢	qìshì	/imposing manner/
氣體	氣體	qìtǐ	/gas (i.e. gaseous substance)/
氣壓	氣壓	qìyā	/atmospheric pressure/
契機	契機	qìjī	/opportunity/
棄權	棄權	qìquán	/to abstain from voting/
恰當	恰當	qiàdàng	/appropriate/
恰好	恰好	qiàhǎo	/as it turns out/
恰恰	恰恰	qiàqià	/exactly/
洽商	洽商	qiàshāng	/to negotiate/
洽談	洽談	qiàtán	/to discuss/
牽連	牽連	qiānlián	/to implicate/
簽署	簽署	qiānshù	/to sign (an agreement)/
謙遜	謙遜	qiānxùn	/humble/
前輩	前輩	qiánbèi	/senior/
前程	前程	qiánchéng	/future (career etc) prospects/
前後	前後	qiánhòu	/around/
前景	前景	qiánjǐng	/foreground/
前科	前科	qiánkē	/criminal record/
前提	前提	qiántí	/premise/
潛藏	潛藏	qiáncáng	/hidden beneath the surface/
潛力	潛力	qiánlì	/potential/
虔誠	虔誠	qiánchéng	/pious/
淺薄	淺薄	qiǎnbó	/superficial/
淺顯	淺顯	qiǎnxiǎn	/plain/
腔調	腔調	qiāngdiào	/accent/
牆角	牆角	qiángjiǎo	/corner (junction of two walls)/
強勁	強勁	qiángjìng	/strong/
強求	強求	qiǎngqiú	/to insist on/
強權	強權	qiángquán	/power/
強壯	強壯	qiángzhuàng	/strong/
瞧不起	瞧不起	qiáobùqǐ	/to look down upon/
橋樑	橋樑	qiáoliáng	//
巧合	巧合	qiǎohé	/coincidence/
俏	俏	qiào	/good-looking/
翹	翹	qiào	/outstanding/
峭壁	峭壁	qiàobì	/cliff/
翹課	翹課	qiàokè	/to skip school/
切磋	切磋	qiēcuō	/to compare notes/
切實	切實	qièshí	/feasible/
竊賊	竊賊	qièzéi	/thief/
親熱	親熱	qīnrè	/affectionate/
親身	親身	qīnshēn	/personal/
親生	親生	qīnshēng	/one's own (child) (i.e. one's child by birth)/
侵犯	侵犯	qīnfàn	/to infringe on/
侵略	侵略	qīnlüè	/invasion/
侵蝕	侵蝕	qīnshí	/to erode/
侵襲	侵襲	qīnxí	/to invade/
欽佩	欽佩	qīnpèi	/to admire/
勤奮	勤奮	qínfèn	/hardworking/
青春	青春	qīngchūn	/youth/
青翠	青翠	qīngcuì	/fresh and green/
青蛙	青蛙	qīngwā	/frog/
清澈	清澈	qīngchè	/clear/
清潔	清潔	qīngjié	/clean/
清靜	清靜	qīngjìng	/quiet/
清廉	清廉	qīnglián	/honest/
清幽	清幽	qīngyōu	/(of a location) quiet and secluded/
清掃	清掃	qīngsǎo	/to tidy up/
輕薄	輕薄	qīngbó	/light (weight)/
輕蔑	輕蔑	qīngmiè	/to contempt/
輕易	輕易	qīngyì	/easily/
情報	情報	qíngbào	/information/
情操	情操	qíngcāo	/sentiments/
情婦	情婦	qíngfù	/mistress/
情節	情節	qíngjié	/plot/
情景	情景	qíngjǐng	/scene/
情侶	情侶	qínglǚ	/sweethearts/
情趣	情趣	qíngqù	/inclinations and interests/
慶幸	慶幸	qìngxìng	/to rejoice/
丘陵	丘陵	qiūlíng	/hills/
求學	求學	qiúxué	/to seek knowledge/
求助	求助	qiúzhù	/to request help/
屈服	屈服	qūfú	/to surrender/
趨勢	趨勢	qūshì	/trend/
渠道	渠道	qúdào	/irrigation ditch/
取材	取材	qǔcái	/to collect material/
取締	取締	qǔdì	/to suppress/
取樣	取樣	qǔyàng	/to take a sample/
取悅	取悅	qǔyuè	/to try to please/
趣味	趣味	qùwèi	/fun/
圈子	圈子	quānzi	/circle/
全力	全力	quánlì	/with all one's strength/
全盤	全盤	quánpán	/overall/
權力	權力	quánlì	/power/
權威	權威	quánwēi	/authority/
權益	權益	quányì	/rights/
泉源	泉源	quányuán	/springhead/
勸導	勸導	quàndǎo	/to advise/
勸告	勸告	quàngào	/to advise/
缺陷	缺陷	quēxiàn	/defect/
確保	確保	quèbǎo	/to ensure/
確切	確切	quèqiè	/definite/
群島	群島	qúndǎo	/group of islands/
群居	群居	qúnjū	/to live together (in a large group or flock)/
染料	染料	rǎnliào	/dye/
嚷	嚷	rǎng	/to blurt out/
饒	饒	ráo	/rich/
熱潮	熱潮	rècháo	/upsurge/
熱帶	熱帶	rèdài	/the tropics/
熱量	熱量	rèliàng	/heat/
熱水瓶	熱水瓶	rèshuǐpíng	/thermos bottle/
仁愛	仁愛	rénài	/benevolence/
人次	人次	réncì	/person-times/
人道	人道	réndào	/human sympathy/
人禍	人禍	rénhuò	/human disaster/
人際	人際	rénjì	/human relationships/
人情	人情	rénqíng	/human emotions/
人群	人群	rénqún	/crowd/
人士	人士	rénshì	/person/
人手	人手	rénshǒu	/manpower/
人選	人選	rénxuǎn	/choice of person/
人造	人造	rénzào	/man-made/
忍痛	忍痛	rěntòng	/to suffer/
任期	任期	rènqí	/term of office/
任意	任意	rènyì	/arbitrary/
認錯	認錯	rèncuò	/to admit an error/
認定	認定	rèndìng	/to maintain (that sth is true)/
日程	日程	rìchéng	/schedule/
日光燈	日光燈	rìguāngdēng	/fluorescent light/
日益	日益	rìyì	/day by day/
容量	容量	róngliàng	/capacity/
容納	容納	róngnà	/to hold/
容器	容器	róngqì	/receptacle/
容許	容許	róngxǔ	/to permit/
溶	溶	róng	/to dissolve/
溶化	溶化	rónghuà	/to melt/
融合	融合	rónghé	/a mixture/
融洽	融洽	róngqià	/harmonious/
榮譽	榮譽	róngyù	/honor/
揉	揉	róu	/to knead/
柔軟	柔軟	róuruǎn	/soft/
肉麻	肉麻	ròumá	/sickening/
肉體	肉體	ròutǐ	/physical body/
儒家	儒家	rújiā	/Confucian school, founded by Confucius 孔子[Kong3 zi3] (551-479 BC) and Mencius 孟子[Meng4 zi3] (c. 372-c. 289 BC)/
入超	入超	rùchāo	//
入世	入世	rùshì	/to join the WTO/
軟弱	軟弱	ruǎnruò	/weak/
軟體	軟體	ruǎntǐ	/software (Tw)/
若干	若干	ruògān	/a certain number or amount/
撒謊	撒謊	sāhuǎng	/to tell lies/
灑	灑	sǎ	/to sprinkle/
塞車	塞車	sāichē	/traffic jam/
散文	散文	sǎnwén	/prose/
散布	散布	sànbù	/to disseminate/
喪事	喪事	sāngshì	/funeral arrangements/
嗓子	嗓子	sǎngzi	/throat/
喪生	喪生	sàngshēng	/to die/
騷動	騷動	sāodòng	/disturbance/
嫂子	嫂子	sǎozi	/(coll.) older brother's wife/
色澤	色澤	sèzé	/color and luster/
剎	剎	shāchē	/to brake/
沙拉	沙拉	shālā	/salad (loanword)/
沙啞	沙啞	shāyǎ	/hoarse/
傻瓜	傻瓜	shǎguā	/idiot/
山峰	山峰	shānfēng	/(mountain) peak/
山谷	山谷	shāngǔ	/valley/
山脈	山脈	shānmài	/mountain range/
閃電	閃電	shǎndiàn	/lightning/
閃爍	閃爍	shǎnshuò	/flickering/
閃耀	閃耀	shǎnyào	/to glint/
擅長	擅長	shàncháng	/to be good at/
傷口	傷口	shāngkǒu	/wound/
傷亡	傷亡	shāngwáng	/casualties/
商榷	商榷	shāngquè	/to discuss/
商討	商討	shāngtǎo	/to discuss/
上吊	上吊	shàngdiào	/to hang oneself/
上好	上好	shànghǎo	/first-rate/
上進	上進	shàngjìn	/to make progress/
上空	上空	shàngkōng	/overhead/
上路	上路	shànglù	/to start on a journey/
上門	上門	shàngmén	/to drop in/
上司	上司	shàngsī	/boss/
上旬	上旬	shàngxún	/first third of a month/
上演	上演	shàngyǎn	/to screen (a movie)/
上癮	上癮	shàngyǐn	/to get into a habit/
上漲	上漲	shàngzhǎng	/to rise/
燒香	燒香	shāoxiāng	/to burn incense/
奢侈	奢侈	shēchǐ	/luxurious/
奢望	奢望	shēwàng	/an extravagant hope/
設施	設施	shèshī	/facilities/
設想	設想	shèxiǎng	/to imagine/
射擊	射擊	shèjí	/to shoot/
射手	射手	shèshǒu	/archer/
涉及	涉及	shèjí	/to involve/
涉嫌	涉嫌	shèxián	/to be a suspect (in a crime)/
社論	社論	shèlùn	/editorial (in a newspaper)/
社區	社區	shèqū	/community/
攝取	攝取	shèqǔ	/to absorb (nutrients etc)/
攝氏	攝氏	shèshì	/Celsius/
攝影機	攝影機	shèyǐngjī	/camera/
深奧	深奧	shēnào	/profound/
深沉	深沉	shēnchén	/deep/
深度	深度	shēndù	/depth/
深厚	深厚	shēnhòu	/deep/
深切	深切	shēnqiè	/deeply felt/
深造	深造	shēnzào	/to pursue one's studies/
身段	身段	shēnduàn	/a woman's physique/
身教	身教	shēnjiào	/to teach by example/
身為	身為	shēnwéi	/in the capacity of/
身子	身子	shēnzi	/body/
伸張	伸張	shēnzhāng	/to uphold (e.g. justice or virtue)/
神情	神情	shénqíng	/look/
審核	審核	shěnhé	/to audit/
審判	審判	shěnpàn	/a trial/
審慎	審慎	shěnshèn	/prudent/
審議	審議	shěnyì	/deliberation/
滲入	滲入	shènrù	/to permeate/
生詞	生詞	shēngcí	/new word (in textbook)/
生火	生火	shēnghuǒ	/to make a fire/
生理	生理	shēnglǐ	/physiology/
生平	生平	shēngpíng	/life (a person's whole life)/
生前	生前	shēngqián	/(of a deceased) during one's life/
生人	生人	shēngrén	/stranger/
生死	生死	shēngsǐ	/life or death/
生態	生態	shēngtài	/ecology/
生物	生物	shēngwù	/organism/
生效	生效	shēngxiào	/to take effect/
生硬	生硬	shēngyìng	/stiff/
生育	生育	shēngyù	/to bear/
生殖	生殖	shēngzhí	/to reproduce/
升遷	升遷	shēngqiān	/promote/
升值	升值	shēngzhí	/to rise in value/
聲稱	聲稱	shēngchēng	/to claim/
聲明	聲明	shēngmíng	/to state/
聲勢	聲勢	shēngshì	/fame and power/
省事	省事	shěngshì	/to simplify matters/
盛情	盛情	shèngqíng	/great kindness/
盛行	盛行	shèngxíng	/to be in vogue/
盛裝	盛裝	shèngzhuāng	/(of a receptacle etc) to contain/
勝地	勝地	shèngdì	/well-known scenic spot/
聖賢	聖賢	shèngxián	/a sage/
失靈	失靈	shīlíng	/out of order (of machine)/
失落	失落	shīluò	/to lose (sth)/
失明	失明	shīmíng	/to lose one's eyesight/
失事	失事	shīshì	/(of a plane, ship etc) to have an accident (plane crash, shipwreck, vehicle collision etc)/
失手	失手	shīshǒu	/a slip/
失蹤	失蹤	shīzōng	/to be missing/
師範	師範	shīfàn	/teacher-training/
施肥	施肥	shīféi	/to spread manure/
施行	施行	shīxíng	/to put in place/
屍體	屍體	shītǐ	/dead body/
石膏	石膏	shígāo	/gypsum CaSO4·2(H2O)/
十足	十足	shízú	/ample/
時差	時差	shíchā	/time difference/
時光	時光	shíguāng	/time/
時節	時節	shíjié	/season/
時髦	時髦	shímáo	/in vogue/
時效	時效	shíxiào	/effectiveness for a given period of time/
實地	實地	shídì	/on-site/
實踐	實踐	shíjiàn	/practice/
實況	實況	shíkuàng	/live (e.g. broadcast or recording)/
實例	實例	shílì	/an actual example/
實習	實習	shíxí	/to practice/
實證	實證	shízhèng	/actual proof/
實質	實質	shízhí	/substance/
屎	屎	shǐ	/stool/
史料	史料	shǐliào	/historical material or data/
使喚	使喚	shǐhuàn	/to order sb about/
使節	使節	shǐjié	/(diplomatic) envoy/
使勁	使勁	shǐjìng	/to exert all one's strength/
使命	使命	shǐmìng	/mission (diplomatic or other)/
士兵	士兵	shìbīng	/soldier/
仕女	仕女	shìnǚ	/court lady/
示範	示範	shìfàn	/to demonstrate/
市面	市面	shìmiàn	/market/
市容	市容	shìróng	/appearance of a city/
世代	世代	shìdài	/for many generations/
世間	世間	shìjiān	/world/
世事	世事	shìshì	/affairs of life/
試卷	試卷	shìjuàn	/examination paper/
試圖	試圖	shìtú	/to attempt/
逝世	逝世	shìshì	/to pass away/
勢必	勢必	shìbì	/to be bound to/
事故	事故	shìgù	/accident/
事變	事變	shìbiàn	/incident/
事態	事態	shìtài	/situation/
事務	事務	shìwù	/(political, economic etc) affairs/
事宜	事宜	shìyí	/matters/
釋放	釋放	shìfàng	/to release/
嗜好	嗜好	shìhào	/hobby/
視為	視為	shìwéi	/to view as/
室友	室友	shìyǒu	/roommate/
適宜	適宜	shìyí	/suitable/
適中	適中	shìzhōng	/moderate/
收藏	收藏	shōucáng	/to hoard/
收費	收費	shōufèi	/to charge a fee/
收集	收集	shōují	/to gather/
收買	收買	shōumǎi	/to purchase/
收縮	收縮	shōusuō	/to pull back/
收聽	收聽	shōutīng	/to listen to (a radio broadcast)/
收益	收益	shōuyì	/earnings/
手冊	手冊	shǒucè	/manual/
手槍	手槍	shǒuqiāng	/pistol/
手勢	手勢	shǒushì	/gesture/
守護	守護	shǒuhù	/to guard/
首府	首府	shǒufǔ	/capital city of an autonomous region/
首領	首領	shǒulǐng	/head/
首席	首席	shǒuxí	/chief (representative, correspondent etc)/
首飾	首飾	shǒushì	/jewelry/
首長	首長	shǒuzhǎng	/senior official/
受害	受害	shòuhài	/to suffer damage, injury etc/
受訓	受訓	shòuxùn	/to receive training/
售貨員	售貨員	shòuhuòyuán	/salesperson/
授課	授課	shòukè	/to teach/
狩獵	狩獵	shòuliè	/to hunt/
壽星	壽星	shòuxīng	/god of longevity/
疏導	疏導	shūdǎo	/to dredge/
疏散	疏散	shūsàn	/to scatter/
梳	梳	shū	/a comb/
書本	書本	shūběn	/book/
書面	書面	shūmiàn	/in writing/
書寫	書寫	shūxiě	/to write/
舒暢	舒暢	shūchàng	/happy/
舒展	舒展	shūzhǎn	/to roll out/
輸血	輸血	shūxiě	/to transfuse blood/
束縛	束縛	shùfú	/to bind/
樹苗	樹苗	shùmiáo	/sapling/
數據	數據	shùjù	/data/
霜	霜	shuāng	/frost/
雙重	雙重	shuāngchóng	/double/
雙打	雙打	shuāngdǎ	/doubles (in sports)/
爽快	爽快	shuǎngkuài	/refreshed/
水道	水道	shuǐdào	/aqueduct/
水稻	水稻	shuǐdào	/rice/
水晶	水晶	shuǐjīng	/crystal/
水庫	水庫	shuǐkù	/reservoir/
水力	水力	shuǐlì	/hydraulic power/
水泥	水泥	shuǐní	/cement/
水源	水源	shuǐyuán	/water source/
水蒸氣	水蒸氣	shuǐzhēngqì	/vapor/
睡眠	睡眠	shuìmián	/sleep/
順從	順從	shùncóng	/obedient/
順應	順應	shùnyìng	/to comply/
瞬間	瞬間	shùnjiān	/in an instant/
說謊	說謊	shuōhuǎng	/to lie/
說笑	說笑	shuōxiào	/to chat and laugh/
思潮	思潮	sīcháo	/tide of thought/
思念	思念	sīniàn	/to think of/
思維	思維	sīwéi	/(line of) thought/
絲毫	絲毫	sīháo	/the slightest amount or degree/
司令	司令	sīlìng	/commanding officer/
斯文	斯文	sīwén	/refined/
私心	私心	sīxīn	/selfishness/
賜	賜	sì	/to confer/
似的	似的	sìde	/seems as if/
松樹	松樹	sōngshù	/pine/
慫恿	慫恿	sǒngyǒng	/to instigate/
搜集	搜集	sōují	/to gather/
俗稱	俗稱	súchēng	/commonly referred to as/
俗語	俗語	súyǔ	/common saying/
塑膠	塑膠	sùjiāo	/plastic/
訴苦	訴苦	sùkǔ	/to grumble/
素食	素食	sùshí	/vegetables/
素質	素質	sùzhí	/inner quality/
算命	算命	suànmìng	/fortune-telling/
算術	算術	suànshù	/arithmetic/
雖說	雖說	suīshuō	/though/
隨後	隨後	suíhòu	/soon after/
隨即	隨即	suíjí	/immediately/
隨身	隨身	suíshēn	/to (carry) on one's person/
隨同	隨同	suítóng	/accompanying/
隧道	隧道	suìdào	/tunnel/
歲月	歲月	suìyuè	/years/
損害	損害	sǔnhài	/harm/
損壞	損壞	sǔnhuài	/to damage/
損傷	損傷	sǔnshāng	/to harm/
縮小	縮小	suōxiǎo	/to reduce/
所得	所得	suǒdé	/what one acquires/
所在	所在	suǒzài	/place/
索賠	索賠	suǒpéi	/to ask for compensation/
瑣碎	瑣碎	suǒsuì	/trifling/
牠	牠	tā	/it (used for animals)/
他人	他人	tārén	/another/
塔	塔	tǎ	/old variant of 塔[ta3]/
踏實	踏實	tàshí	/firmly-based/
台階	台階	táijiē	//
太極拳	太極拳	tàijíquán	/shadowboxing or Taiji, T'aichi or T'aichichuan/
太平	太平	tàipíng	/place name/
態勢	態勢	tàishì	/posture/
貪	貪	tān	/to have a voracious desire for/
貪心	貪心	tānxīn	/greedy/
攤位	攤位	tānwèi	/vendor's booth/
痰	痰	tán	/phlegm/
談論	談論	tánlùn	/to discuss/
彈性	彈性	tánxìng	/flexibility/
坦克	坦克	tǎnkè	/tank (military vehicle) (loanword)/
坦然	坦然	tǎnrán	/calm/
探病	探病	tànbìng	/to visit a sick person or patient/
探究	探究	tànjiù	/to investigate/
探索	探索	tànsuǒ	/to explore/
探望	探望	tànwàng	/to visit/
探險	探險	tànxiǎn	/to explore/
湯圓	湯圓	tāngyuán	/boiled balls of glutinous rice flour, eaten during the Lantern Festival/
堂堂	堂堂	tángtáng	/grand/
倘若	倘若	tǎngruò	/provided that/
陶器	陶器	táoqì	/pottery/
逃生	逃生	táoshēng	/to flee for one's life/
逃稅	逃稅	táoshuì	/to evade a tax/
淘汰	淘汰	táotài	/to wash out/
套房	套房	tàofáng	/suite/
套裝	套裝	tàozhuāng	/outfit or suit (of clothes)/
特此	特此	tècǐ	/hereby/
特區	特區	tèqū	/special administrative region/
特權	特權	tèquán	/prerogative/
特約	特約	tèyuē	/specially engaged/
特徵	特徵	tèzhēng	/characteristic/
疼愛	疼愛	téngài	/to love dearly/
剔除	剔除	tīchú	/to reject/
啼	啼	tí	/variant of 啼[ti2]/
提拔	提拔	tíbá	/to promote to a higher job/
提倡	提倡	tíchàng	/to promote/
提出	提出	tíchū	/to raise (an issue)/
提及	提及	tíjí	/to mention/
提名	提名	tímíng	/to nominate/
提升	提升	tíshēng	/to promote/
提議	提議	tíyì	/proposal/
體操	體操	tǐcāo	/gymnastic/
體格	體格	tǐgé	/bodily health/
體積	體積	tǐjī	/volume/
體諒	體諒	tǐliang	/to empathize/
體面	體面	tǐmiàn	/dignity/
體系	體系	tǐxì	/system/
體質	體質	tǐzhí	/constitution/
替代	替代	tìdài	/to substitute for/
添	添	tiān	/to add/
天敵	天敵	tiāndí	/predator/
天然氣	天然氣	tiānránqì	/natural gas/
天性	天性	tiānxìng	/nature/
天災	天災	tiānzāi	/natural disaster/
田地	田地	tiándì	/field/
田徑	田徑	tiánjìng	/track and field (athletics)/
甜美	甜美	tiánměi	/sweet/
挑剔	挑剔	tiāoti	/picky/
調和	調和	tiáohé	/harmonious/
調節	調節	tiáojié	/to adjust/
調皮	調皮	tiáopí	/naughty/
條例	條例	tiáolì	/regulations/
聽寫	聽寫	tīngxiě	/(of a pupil) to write down (in a dictation exercise)/
停頓	停頓	tíngdùn	/to halt/
停留	停留	tíngliú	/to stay somewhere temporarily/
停滯	停滯	tíngzhì	/stagnation/
通報	通報	tōngbào	/to inform/
通車	通車	tōngchē	/to open to traffic (e.g. new bridge, rail line etc)/
通稱	通稱	tōngchēng	/generic term/
通貨膨脹	通貨膨脹	tōnghuòpéngzhàng	/inflation/
通緝	通緝	tōngqì	/to order the arrest of sb as criminal/
通行	通行	tōngxíng	/to go through/
通用	通用	tōngyòng	/common (use)/
同伴	同伴	tóngbàn	/companion/
同化	同化	tónghuà	/assimilation (cultural, digestive, phonemic etc)/
同鄉	同鄉	tóngxiāng	/person from the same village, town, or province/
同心	同心	tóngxīn	/to be of one mind/
同性戀	同性戀	tóngxìngliàn	/homosexuality/
同業	同業	tóngyè	/same trade or business/
統統	統統	tǒngtǒng	/totally/
統制	統制	tǒngzhì	/to control/
痛恨	痛恨	tònghèn	/to detest/
偷渡	偷渡	tōudù	/illegal immigration/
偷懶	偷懶	tōulǎn	/to goof off/
投保	投保	tóubǎo	/to take out insurance/
投機	投機	tóujī	/to speculate (on financial markets)/
透明	透明	tòumíng	/transparent/
徒弟	徒弟	túdì	/apprentice/
突擊	突擊	tújí	/sudden and violent attack/
突兀	突兀	túwù	/lofty or towering/
圖表	圖表	túbiǎo	/chart/
圖畫	圖畫	túhuà	/drawing/
圖騰	圖騰	túténg	/totem (loanword)/
土壤	土壤	tǔrǎng	/soil/
團聚	團聚	tuánjù	/to reunite/
團員	團員	tuányuán	/member/
推測	推測	tuīcè	/speculation/
推崇	推崇	tuīchóng	/to esteem/
推出	推出	tuīchū	/to push out/
推選	推選	tuīxuǎn	/to elect/
退化	退化	tuìhuà	/to degenerate/
吞吞吐吐	吞吞吐吐	tūntūntǔtǔ	/to hum and haw (idiom); to mumble as if hiding sth/
拖累	拖累	tuōlèi	/to encumber/
拖延	拖延	tuōyán	/to delay/
脫身	脫身	tuōshēn	/to get away/
脫手	脫手	tuōshǒu	/(not of regular commerce) to sell or dispose of (goods etc)/
瓦斯	瓦斯	wǎsī	/gas (loanword)/
外表	外表	wàibiǎo	/external/
外號	外號	wàihào	/nickname/
外力	外力	wàilì	/external force/
外貿	外貿	wàimào	/foreign trade/
外線	外線	wàixiàn	//
外銷	外銷	wàixiāo	/to export/
外遇	外遇	wàiyù	/extramarital affair/
外在	外在	wàizài	/external/
外資	外資	wàizī	/foreign investment/
外祖父	外祖父	wàizǔfù	/maternal grandfather (i.e. mother's father)/
外祖母	外祖母	wàizǔmǔ	/mother's mother/
彎曲	彎曲	wānqū	/to bend/
完備	完備	wánbèi	/faultless/
完美	完美	wánměi	/perfect/
玩弄	玩弄	wánnòng	/to play with/
頑強	頑強	wánqiáng	/tenacious/
挽	挽	wǎn	/to draw (a cart)/
挽救	挽救	wǎnjiù	/to save/
萬分	萬分	wànfēn	/very much/
萬事	萬事	wànshì	/all things/
萬歲	萬歲	wànsuì	/Long live (the king, the revolution etc)!/
萬萬	萬萬	wànwàn	/absolutely/
萬物	萬物	wànwù	/all living things/
惋惜	惋惜	wànxí	/to regret/
亡國	亡國	wángguó	/(of a nation) to be destroyed/
往來	往來	wǎnglái	/dealings/
旺季	旺季	wàngjì	/busy season/
旺盛	旺盛	wàngshèng	/vigorous/
威風	威風	wēifēng	/might/
威力	威力	wēilì	/might/
萎縮	萎縮	wēisuō	/to wither/
為人	為人	wéirén	/to conduct oneself/
為生	為生	wéishēng	/to make a living/
為首	為首	wéishǒu	/head/
為止	為止	wéizhǐ	/until/
違背	違背	wéibèi	/to go against/
違約	違約	wéiyuē	/to break a promise/
危害	危害	wéihài	/to jeopardize/
圍巾	圍巾	wéijīn	/scarf/
圍牆	圍牆	wéiqiáng	/perimeter wall/
圍繞	圍繞	wéirào	/to revolve around/
微弱	微弱	wéiruò	/weak/
微小	微小	wéixiǎo	/minute (i.e. extremely small)/
維生素	維生素	wéishēngsù	/vitamin/
胃	胃	wèi	/stomach/
胃口	胃口	wèikǒu	/appetite/
未必	未必	wèibì	/not necessarily/
未婚夫	未婚夫	wèihūnfū	/fiancé/
未婚妻	未婚妻	wèihūnqī	/fiancée/
未免	未免	wèimiǎn	/unavoidably/
溫帶	溫帶	wēndài	/temperate zone/
溫泉	溫泉	wēnquán	/hot spring/
溫習	溫習	wēnxí	/to review (a lesson etc)/
溫馴	溫馴	wēnxún	/docile/
瘟疫	瘟疫	wēnyì	/epidemic/
文明	文明	wénmíng	/civilized/
文壇	文壇	wéntán	/literary circles/
文獻	文獻	wénxiàn	/document/
聞名	聞名	wénmíng	/well-known/
穩健	穩健	wěnjiàn	/firm/
紊亂	紊亂	wènluàn	/disorder/
問世	問世	wènshì	/to be published/
烏龜	烏龜	wūguī	/tortoise/
烏龍茶	烏龍茶	wūlóngchá	/oolong tea/
烏鴉	烏鴉	wūyā	/crow/
汙染	汙染	wūrǎn	//
無比	無比	wúbǐ	/incomparable/
無線電	無線電	wúxiàndiàn	/wireless/
無形	無形	wúxíng	/incorporeal/
無疑	無疑	wúyí	/no doubt/
五金	五金	wǔjīn	/metal hardware (nuts and bolts)/
武力	武力	wǔlì	/military force/
武士	武士	wǔshì	/warrior/
武裝	武裝	wǔzhuāng	/arms/
侮辱	侮辱	wǔrù	/to insult/
物產	物產	wùchǎn	/products/
物品	物品	wùpǐn	/articles/
物體	物體	wùtǐ	/object/
物資	物資	wùzī	/goods/
誤差	誤差	wùchā	/difference/
誤解	誤解	wùjiě	/to misunderstand/
務實	務實	wùshí	/pragmatic/
西服	西服	xīfú	/suit/
西洋	西洋	xīyáng	/the West (Europe and North America)/
西醫	西醫	xīyī	/Western medicine/
溪流	溪流	xīliú	/stream/
席位	席位	xíwèi	/a seat (in a theater, stadium etc)/
錫	錫	xí	/tin (chemistry)/
襲擊	襲擊	xíjí	/attack (esp. surprise attack)/
昔日	昔日	xírì	/formerly/
習題	習題	xítí	/(schoolwork) exercise/
洗禮	洗禮	xǐlǐ	/baptism (lit. or fig.)/
喜氣	喜氣	xǐqì	/hilarity/
喜悅	喜悅	xǐyuè	/happy/
戲曲	戲曲	xìqǔ	/Chinese opera/
瑕疵	瑕疵	xiácī	/blemish/
峽谷	峽谷	xiágǔ	/canyon/
狹小	狹小	xiáxiǎo	/narrow/
狹窄	狹窄	xiázhǎi	/narrow/
下筆	下筆	xiàbǐ	/to put pen to paper/
下跌	下跌	xiàdié	/to fall/
下滑	下滑	xiàhuá	/sliding/
下列	下列	xiàliè	/following/
下水	下水	xiàshuǐ	/downstream/
下水道	下水道	xiàshuǐdào	/sewer/
下旬	下旬	xiàxún	/last third of the month/
掀	掀	xiān	/to lift (a lid)/
仙丹	仙丹	xiāndān	/elixir/
先後	先後	xiānhòu	/early or late/
先驅	先驅	xiānqū	/pioneer/
先天	先天	xiāntiān	/inborn/
鮮明	鮮明	xiānmíng	/bright/
鮮艶	鮮艶	xiānyàn	//
纖維	纖維	xiānwéi	/fiber/
嫌疑	嫌疑	xiányí	/suspicion/
顯現	顯現	xiǎnxiàn	/appearance/
限度	限度	xiàndù	/limitation/
憲法	憲法	xiànfǎ	/constitution (of a country)/
線路	線路	xiànlù	/line/
陷入	陷入	xiànrù	/to sink into/
獻身	獻身	xiànshēn	/to commit one's energy to/
現今	現今	xiànjīn	/now/
現行	現行	xiànxíng	/to be in effect/
現狀	現狀	xiànzhuàng	/current situation/
相傳	相傳	xiāngchuán	/to pass on/
相仿	相仿	xiāngfǎng	/similar/
相符	相符	xiāngfú	/to match/
相繼	相繼	xiāngjì	/in succession/
相配	相配	xiāngpèi	/to match/
鄉土	鄉土	xiāngtǔ	/native soil/
香皂	香皂	xiāngzào	/perfumed soap/
鑲	鑲	xiāng	/to inlay/
想開	想開	xiǎngkāi	/to get over (a shock, bereavement etc)/
響亮	響亮	xiǎngliàng	/loud and clear/
嚮導	嚮導	xiàngdǎo	/guide/
嚮往	嚮往	xiàngwǎng	/to yearn for/
象徵	象徵	xiàngzhēng	/emblem/
消毒	消毒	xiāodú	/to disinfect/
消防	消防	xiāofáng	/firefighting/
消耗	消耗	xiāohào	/to use up/
消遣	消遣	xiāoqiǎn	/to while the time away/
瀟灑	瀟灑	xiāosǎ	/confident and at ease/
逍遙	逍遙	xiāoyáo	/free and unfettered/
小販	小販	xiǎofàn	/peddler/
小伙	小伙	xiǎohuǒzi	/young guy/
效法	效法	xiàofǎ	/to imitate/
效勞	效勞	xiàoláo	/to serve (in some capacity)/
效力	效力	xiàolì	/effectiveness/
效忠	效忠	xiàozhōng	/to vow loyalty and devotion to/
笑嘻嘻	笑嘻嘻	xiàoxīxī	//
孝子	孝子	xiàozǐ	/filial son/
協辦	協辦	xiébàn	/to assist/
協定	協定	xiédìng	/(reach an) agreement/
協會	協會	xiéhuì	/an association/
協商	協商	xiéshāng	/to consult with/
協調	協調	xiétiáo	/to coordinate/
協議	協議	xiéyì	/agreement/
血汗	血汗	xiěhàn	/blood and sweat/
血跡	血跡	xiějī	/bloodstain/
血壓	血壓	xiěyā	/blood pressure/
寫實	寫實	xiěshí	/realism/
寫作	寫作	xiězuò	/to write/
洩氣	洩氣	xièqì	/to leak (gas)/
心愛	心愛	xīnài	/beloved/
心軟	心軟	xīnruǎn	/to be softhearted/
心事	心事	xīnshi	/a load on one's mind/
心思	心思	xīnsī	/mind/
心酸	心酸	xīnsuān	/to feel sad/
心態	心態	xīntài	/attitude (of the heart)/
心疼	心疼	xīnténg	/to love dearly/
心胸	心胸	xīnxiōng	/breadth of mind/
辛勤	辛勤	xīnqín	/hardworking/
辛酸	辛酸	xīnsuān	/pungent (taste)/
新潮	新潮	xīncháo	/modern/
新手	新手	xīnshǒu	/new hand/
新穎	新穎	xīnyǐng	/lit. new bud/
信賴	信賴	xìnlài	/to trust/
信念	信念	xìnniàn	/faith/
信徒	信徒	xìntú	/believer/
信息	信息	xìnxí	/information/
星辰	星辰	xīngchén	/stars/
星座	星座	xīngzuò	/constellation/
興建	興建	xīngjiàn	/to build/
興隆	興隆	xīnglóng	/prosperous/
興起	興起	xīngqǐ	/to rise/
行善	行善	xíngshàn	/to do good works/
行使	行使	xíngshǐ	/to exercise (a right etc)/
行星	行星	xíngxīng	/planet/
行政	行政	xíngzhèng	/administrative/
刑事	刑事	xíngshì	/criminal/
形勢	形勢	xíngshì	/circumstances/
形態	形態	xíngtài	/shape/
形體	形體	xíngtǐ	/figure/
形形色色	形形色色	xíngxíngsèsè	/all kinds of/
型態	型態	xíngtài	/form/
性能	性能	xìngnéng	/function/
性情	性情	xìngqing	/nature/
興致	興致	xìngzhì	/mood/
胸口	胸口	xiōngkǒu	/pit of the stomach/
修補	修補	xiūbǔ	/to mend/
修訂	修訂	xiūdìng	/to revise/
修建	修建	xiūjiàn	/to build/
修女	修女	xiūnǚ	/nun or sister (of the Roman Catholic or Greek Orthodox churches)/
修養	修養	xiūyǎng	/accomplishment/
修築	修築	xiūzhú	/to build/
繡	繡	xiù	/to embroider/
虛擬	虛擬	xūnǐ	/to imagine/
虛心	虛心	xūxīn	/open-minded/
許久	許久	xǔjiǔ	/for a long time/
許可	許可	xǔkě	/to allow/
酗酒	酗酒	xùjiǔ	/heavy drinking/
序幕	序幕	xùmù	/prologue/
敘述	敘述	xùshù	/to relate (a story or information)/
宣稱	宣稱	xuānchēng	/to assert/
宣告	宣告	xuāngào	/to declare/
宣示	宣示	xuānshì	/to vow/
宣誓	宣誓	xuānshì	/to swear an oath (of office)/
宣言	宣言	xuānyán	/declaration/
宣揚	宣揚	xuānyáng	/to proclaim/
旋律	旋律	xuánlǜ	/melody/
旋轉	旋轉	xuánzhuǎn	/to rotate/
懸殊	懸殊	xuánshū	/widely different/
懸崖	懸崖	xuányái	/precipice/
選拔	選拔	xuǎnbá	/to select the best/
選購	選購	xuǎngòu	/to select and purchase/
選民	選民	xuǎnmín	/voter/
選票	選票	xuǎnpiào	/a vote/
選修	選修	xuǎnxiū	/optional course (in school)/
學分	學分	xuéfēn	/course credit/
學科	學科	xuékē	/subject/
學年	學年	xuénián	/academic year/
學識	學識	xuéshì	/erudition/
學說	學說	xuéshuō	/theory/
學徒	學徒	xuétú	/apprentice/
學員	學員	xuéyuán	/student/
學制	學制	xuézhì	/educational system/
雪人	雪人	xuěrén	/snowman/
削弱	削弱	xuèruò	/to weaken/
巡邏	巡邏	xúnluó	/to patrol (police, army or navy)/
巡視	巡視	xúnshì	/to patrol/
詢問	詢問	xúnwèn	/to inquire/
鴉片	鴉片	yāpiàn	/opium (loanword)/
壓歲錢	壓歲錢	yāsuìqián	/money given to children as new year present/
壓縮	壓縮	yāsuō	/to compress/
壓制	壓制	yāzhì	/to suppress/
牙科	牙科	yákē	/dentistry/
芽	芽	yá	/bud/
亞軍	亞軍	yàjūn	/second place (in a sports contest)/
亞洲	亞洲	yàzhōu	/Asia/
淹	淹	yān	/to flood/
研究所	研究所	yánjiùsuǒ	/research institute/
言論	言論	yánlùn	/expression of opinion/
岩石	岩石	yánshí	/rock/
延遲	延遲	yánchí	/to delay/
延伸	延伸	yánshēn	/to extend/
延誤	延誤	yánwù	/to delay/
延續	延續	yánxù	/to continue/
沿海	沿海	yánhǎi	/coastal/
沿途	沿途	yántú	/along the sides of the road/
沿襲	沿襲	yánxí	/to carry on as before/
沿用	沿用	yányòng	/to continue to use (old methods)/
嚴禁	嚴禁	yánjìn	/to strictly prohibit/
嚴厲	嚴厲	yánlì	/severe/
嚴密	嚴密	yánmì	/strict/
演變	演變	yǎnbiàn	/to develop/
演說	演說	yǎnshuō	/speech/
演習	演習	yǎnxí	/maneuver/
眼界	眼界	yǎnjiè	/ken/
眼看	眼看	yǎnkàn	/soon/
衍生	衍生	yǎnshēng	/to give rise to/
燕窩	燕窩	yànwō	/swallow's nest/
燕子	燕子	yànzi	/swallow/
央求	央求	yāngqiú	/to implore/
仰慕	仰慕	yǎngmù	/to admire/
養分	養分	yǎngfèn	/nutrient/
養老	養老	yǎnglǎo	/to provide for the elderly (family members)/
養育	養育	yǎngyù	/to rear/
窯	窯	yáo	/kiln/
搖晃	搖晃	yáohuang	/to rock/
謠言	謠言	yáoyan	/rumor/
遙遠	遙遠	yáoyuǎn	/distant/
要點	要點	yàodiǎn	/main point/
要犯	要犯	yàofàn	/major criminal/
藥品	藥品	yàopǐn	/medicaments/
業績	業績	yèjī	/achievement/
依舊	依舊	yījiù	/as before/
依賴	依賴	yīlài	/to depend on/
依照	依照	yīzhào	/according to/
醫療	醫療	yīliáo	/medical treatment/
醫術	醫術	yīshù	/medical expertise/
醫藥	醫藥	yīyào	/medical care and medicines/
一道	一道	yīdào	/together/
一度	一度	yīdù	/for a time/
一概	一概	yīgài	/all/
一貫	一貫	yīguàn	/consistent/
一律	一律	yīlǜ	/same/
一味	一味	yīwèi	/blindly/
咦	咦	yí	/expression of surprise/
儀表	儀表	yíbiǎo	/appearance/
遺產	遺產	yíchǎn	/heritage/
遺傳	遺傳	yíchuán	/heredity/
遺憾	遺憾	yíhàn	/regret/
遺留	遺留	yíliú	/to leave behind/
遺棄	遺棄	yíqì	/to leave/
遺體	遺體	yítǐ	/remains (of a dead person)/
遺忘	遺忘	yíwàng	/to become forgotten/
遺志	遺志	yízhì	/the mission in life of a deceased person, left to others to carry on/
遺址	遺址	yízhǐ	/ruins/
疑慮	疑慮	yílǜ	/hesitation/
移植	移植	yízhí	/to transplant/
倚	倚	yǐ	/to lean on/
以至	以至	yǐzhì	/down to/
亦	亦	yì	/also/
一連串	一連串	yīliánchuàn	/a succession of/
一流	一流	yīliú	/top quality/
一如	一如	yīrú	/to be just like/
一心	一心	yīxīn	/wholeheartedly/
液體	液體	yètǐ	/liquid/
抑制	抑制	yìzhì	/to inhibit/
意識到	意識到	yìshìdào	//
意圖	意圖	yìtú	/intent/
意味	意味	yìwèi	/meaning/
毅力	毅力	yìlì	/perseverance/
翌日	翌日	yìrì	/next day/
異常	異常	yìcháng	/exceptional/
異鄉	異鄉	yìxiāng	/foreign land/
議定	議定	yìdìng	/to reach an agreement/
議論	議論	yìlùn	/to comment/
議題	議題	yìtí	/topic of discussion/
議員	議員	yìyuán	/member (of a legislative body)/
因果	因果	yīnguǒ	/karma/
陰謀	陰謀	yīnmóu	/plot/
陰影	陰影	yīnyǐng	/(lit. and fig.) shadow/
銀幕	銀幕	yínmù	/movie screen/
銀色	銀色	yínsè	/silver (color)/
銀子	銀子	yínzi	/money/
引導	引導	yǐndǎo	/to guide/
引進	引進	yǐnjìn	/to recommend/
引擎	引擎	yǐnqíng	/engine (loanword)/
隱藏	隱藏	yǐncáng	/to hide/
隱士	隱士	yǐnshì	/hermit/
隱約	隱約	yǐnyuē	/vague/
印證	印證	yìnzhèng	/to seal/
櫻桃	櫻桃	yīngtáo	/cherry/
英勇	英勇	yīngyǒng	/heroic/
英語	英語	yīngyǔ	/English (language)/
鷹	鷹	yīng	/eagle/
營地	營地	yíngdì	/camp/
營造	營造	yíngzào	/to build (housing)/
迎合	迎合	yínghé	/to cater to/
影射	影射	yǐngshè	/to refer obliquely to/
硬體	硬體	yìngtǐ	/(computer) hardware/
應變	應變	yìngbiàn	/to meet a contingency/
應酬	應酬	yìngchóu	/social niceties/
應急	應急	yìngjí	/to respond to an emergency/
應驗	應驗	yìngyàn	/to come true/
應徵	應徵	yìngzhēng	/to apply (for a job)/
唷	唷	yō	/(interjection expressing surprise) Oh!/
湧	湧	yǒng	/to bubble up/
踴躍	踴躍	yǒngyuè	/to leap/
用戶	用戶	yònghù	/user/
用途	用途	yòngtú	/use/
悠久	悠久	yōujiǔ	/long (tradition, history etc)/
悠閒	悠閒	yōuxián	/leisurely/
優待	優待	yōudài	/preferential treatment/
優勢	優勢	yōushì	/superiority/
優先	優先	yōuxiān	/to have priority/
優異	優異	yōuyì	/exceptional/
鈾	鈾	yòu	/uranium (chemistry)/
由來	由來	yóulái	/origin/
遊覽	遊覽	yóulǎn	/to go sightseeing/
油田	油田	yóutián	/oil field/
油條	油條	yóutiáo	/youtiao (deep-fried breadstick)/
友愛	友愛	yǒuài	/friendly affection/
有機	有機	yǒujī	/organic/
有理	有理	yǒulǐ	/reasonable/
有所	有所	yǒusuǒ	/somewhat/
有為	有為	yǒuwéi	/promising/
有限	有限	yǒuxiàn	/limited/
有形	有形	yǒuxíng	/material/
有心人	有心人	yǒuxīnrén	/resolute person/
有益	有益	yǒuyì	/useful/
有意	有意	yǒuyì	/to intend/
有緣	有緣	yǒuyuán	/related/
誘惑	誘惑	yòuhuò	/to entice/
幼稚	幼稚	yòuzhì	/young/
于	于	yú	/in/
逾	逾	yú	/to exceed/
愚蠢	愚蠢	yúchǔn	/silly/
輿論	輿論	yúlùn	/public opinion/
漁民	漁民	yúmín	/fisherman/
予以	予以	yǔyǐ	/to give/
與會	與會	yùhuì	/to participate in a meeting/
雨季	雨季	yǔjì	/rainy season/
語文	語文	yǔwén	/literature and language/
宇宙	宇宙	yǔzhòu	/universe/
愈	愈	yù	/to heal/
玉器	玉器	yùqì	/jade artifact/
預測	預測	yùcè	/to forecast/
預防	預防	yùfáng	/to prevent/
預告	預告	yùgào	/to forecast/
預估	預估	yùgū	/to estimate/
預賽	預賽	yùsài	/preliminary competition/
預約	預約	yùyuē	/booking/
寓言	寓言	yùyán	/fable/
園林	園林	yuánlín	/gardens/
元氣	元氣	yuánqì	/strength/
元首	元首	yuánshǒu	/head of state/
元素	元素	yuánsù	/element/
原本	原本	yuánběn	/originally/
原形	原形	yuánxíng	/original shape/
原野	原野	yuányě	/plain/
原狀	原狀	yuánzhuàng	/previous condition/
原住民	原住民	yuánzhùmín	/indigenous peoples/
原子	原子	yuánzǐ	/atom/
原子彈	原子彈	yuánzǐdàn	/atom bomb/
援助	援助	yuánzhù	/to help/
遠景	遠景	yuǎnjǐng	/prospect/
約束	約束	yuēshù	/to restrict/
樂隊	樂隊	yuèduì	/band/
月台	月台	yuètái	/railway platform/
運行	運行	yùnxíng	/to move along one's course (of celestial bodies etc)/
孕婦	孕婦	yùnfù	/pregnant woman/
醞釀	醞釀	yùnniàng	/(of alcohol) to ferment/
栽	栽	zāi	/to grow/
災禍	災禍	zāihuò	/disaster/
災情	災情	zāiqíng	/disastrous situation/
在場	在場	zàichǎng	/to be present/
在世	在世	zàishì	/to be alive/
在座	在座	zàizuò	/to be present/
再三	再三	zàisān	/over and over again/
再生	再生	zàishēng	/to be reborn/
贊助	贊助	zànzhù	/to support/
讚嘆	讚嘆	zàntàn	/to exclaim in admiration/
贓物	贓物	zāngwù	/booty/
造反	造反	zàofǎn	/to rebel/
造化	造化	zàohuà	/good luck/
造物主	造物主	zàowùzhǔ	/the Creator (in religion or mythology)/
造型	造型	zàoxíng	/to model/
責備	責備	zébèi	/to blame/
增進	增進	zēngjìn	/to promote/
增強	增強	zēngqiáng	/to increase/
增值	增值	zēngzhí	/to appreciate (financially)/
扎	扎	zhā	/to tie/
炸藥	炸藥	zhàyào	/explosive (material)/
沾	沾	zhān	/to moisten/
盞	盞	zhǎn	/a small cup/
展望	展望	zhǎnwàng	/outlook/
展現	展現	zhǎnxiàn	/to come out/
嶄新	嶄新	zhǎnxīn	/brand new/
顫抖	顫抖	zhàndǒu	/to shudder/
戰火	戰火	zhànhuǒ	/conflagration/
戰機	戰機	zhànjī	/opportunity in a battle/
戰亂	戰亂	zhànluàn	/chaos of war/
戰略	戰略	zhànlüè	/strategy/
戰勝	戰勝	zhànshèng	/to prevail over/
戰士	戰士	zhànshì	/fighter/
戰術	戰術	zhànshù	/tactics/
戰線	戰線	zhànxiàn	/battle line/
戰友	戰友	zhànyǒu	/comrade-in-arms/
戰戰兢兢	戰戰兢兢	zhànzhànjīngjīng	/trembling with fear/
張開	張開	zhāngkāi	/to open up/
張貼	張貼	zhāngtiē	/to post (a notice)/
長子	長子	zhǎngzǐ	/eldest son/
帳篷	帳篷	zhàngpéng	/tent/
朝氣	朝氣	zhāoqì	/vitality/
著想	著想	zháoxiǎng	/to give thought (to others)/
找尋	找尋	zhǎoxún	/to look for/
沼澤	沼澤	zhǎozé	/marsh/
召集	召集	zhàojí	/to convene/
照例	照例	zhàolì	/as a rule/
照耀	照耀	zhàoyào	/to shine/
遮	遮	zhē	/to cover up (a shortcoming)/
遮蔽	遮蔽	zhēbì	/to cover/
折騰	折騰	zhēteng	/to toss from side to side (e.g. sleeplessly)/
針灸	針灸	zhēnjiǔ	/acupuncture and moxibustion/
真情	真情	zhēnqíng	/real situation/
診斷	診斷	zhěnduàn	/diagnosis/
診所	診所	zhěnsuǒ	/clinic/
鎮定	鎮定	zhèndìng	/calm/
鎮壓	鎮壓	zhènyā	/suppression/
振動	振動	zhèndòng	/to vibrate/
震驚	震驚	zhènjīng	/to shock/
陣營	陣營	zhènyíng	/group of people/
蒸發	蒸發	zhēngfā	/to evaporate/
蒸氣	蒸氣	zhēngqì	/vapor/
爭辯	爭辯	zhēngbiàn	/a dispute/
爭奪	爭奪	zhēngduó	/to fight over/
爭氣	爭氣	zhēngqì	/to work hard for sth/
爭議	爭議	zhēngyì	/controversy/
徵收	徵收	zhēngshōu	/to levy (a fine)/
掙扎	掙扎	zhēngzhá	/to struggle/
整頓	整頓	zhěngdùn	/to tidy up/
整體	整體	zhěngtǐ	/whole entity/
整整	整整	zhěngzhěng	/whole/
正當	正當	zhèngdāng	/timely/
正統	正統	zhèngtǒng	/Zhengtong Emperor, reign name of sixth Ming Emperor Zhu Qizhen 朱祁鎮|朱祁镇[Zhu1 Qi2 zhen4] (1427-1464), reigned 1435-1449, Temple name Yingzong 英宗[Ying1 zong1]/
正義	正義	zhèngyì	/justice/
政績	政績	zhèngjī	/(political) achievements/
政見	政見	zhèngjiàn	/political views/
政權	政權	zhèngquán	/regime/
證券	證券	zhèngquàn	/negotiable security (financial)/
證人	證人	zhèngrén	/witness/
之內	之內	zhīnèi	/inside/
之所以	之所以	zhīsuǒyǐ	/the reason why/
支撐	支撐	zhīchēng	/to prop up/
支付	支付	zhīfù	/to pay (money)/
支配	支配	zhīpèi	/to control/
支應	支應	zhīyìng	/to deal with/
知足	知足	zhīzú	/content with one's situation/
脂肪	脂肪	zhīfáng	/fat (in the body, in a plant, or in food)/
直徑	直徑	zhíjìng	/diameter/
值班	值班	zhíbān	/to work a shift/
值錢	值錢	zhíqián	/valuable/
殖民	殖民	zhímín	/colony/
質量	質量	zhíliàng	/quality/
質疑	質疑	zhíyí	/to call into question/
職務	職務	zhíwù	/post/
職責	職責	zhízé	/duty/
執照	執照	zhízhào	/license/
執政	執政	zhízhèng	/to hold power/
執著	執著	zhízhuó	/to be strongly attached to/
只得	只得	zhǐdé	/to have no alternative but to/
指標	指標	zhǐbiāo	/(production) target/
指點	指點	zhǐdiǎn	/to point out/
指揮	指揮	zhǐhuī	/to conduct/
指控	指控	zhǐkòng	/accusation/
指南針	指南針	zhǐnánzhēn	/compass/
指數	指數	zhǐshù	/(numerical, statistical) index/
指頭	指頭	zhǐtou	/finger/
指望	指望	zhǐwàng	/to hope for sth/
指紋	指紋	zhǐwén	/fingerprint/
指引	指引	zhǐyǐn	/to guide/
指正	指正	zhǐzhèng	/to point out mistakes or weak points for correction/
至今	至今	zhìjīn	/so far/
治安	治安	zhìān	/law and order/
治本	治本	zhìběn	/to take radical measures/
治標	治標	zhìbiāo	/to treat only the symptoms but not the root cause/
治理	治理	zhìlǐ	/to govern/
治療	治療	zhìliáo	/to treat (an illness)/
志趣	志趣	zhìqù	/inclination/
志向	志向	zhìxiàng	/ambition/
致詞	致詞	zhìcí	/to make a speech/
致富	致富	zhìfù	/to become rich/
致力	致力	zhìlì	/to work for/
致命	致命	zhìmìng	/fatal/
致意	致意	zhìyì	/to send one's greetings/
智力	智力	zhìlì	/intelligence/
制裁	制裁	zhìcái	/to punish/
制訂	制訂	zhìdìng	/to work out/
製品	製品	zhìpǐn	/products/
滯留	滯留	zhìliú	/to detain/
中斷	中斷	zhōngduàn	/to cut short/
中和	中和	zhōnghé	/to neutralize/
中立	中立	zhōnglì	/neutral/
中旬	中旬	zhōngxún	/middle third of a month/
中葉	中葉	zhōngyè	/mid- (e.g. mid-century)/
中醫	中醫	zhōngyī	/traditional Chinese medical science/
中庸	中庸	zhōngyōng	/the Doctrine of the Mean, one of the Four Books 四書|四书[Si4 shu1]/
忠實	忠實	zhōngshí	/faithful/
衷心	衷心	zhōngxīn	/heartfelt/
終場	終場	zhōngchǎng	/end (of a performance or sports match)/
終結	終結	zhōngjié	/end/
終究	終究	zhōngjiù	/in the end/
終身	終身	zhōngshēn	/lifelong/
種種	種種	zhǒngzhǒng	/all kinds of/
種植	種植	zhòngzhí	/to plant/
中風	中風	zhòngfēng	/to suffer a paralyzing stroke/
中獎	中獎	zhòngjiǎng	/to win a prize/
中肯	中肯	zhòngkěn	/pertinent/
中暑	中暑	zhòngshǔ	/sunstroke/
重用	重用	zhòngyòng	/to put in an important position/
重鎮	重鎮	zhòngzhèn	/strategic town/
周邊	周邊	zhōubiān	/periphery/
周密	周密	zhōumì	/careful/
周詳	周詳	zhōuxiáng	/meticulous/
周遊	周遊	zhōuyóu	/to travel around/
周轉	周轉	zhōuzhuǎn	/to rotate/
皺	皺	zhòu	/to wrinkle/
皺紋	皺紋	zhòuwén	/wrinkle/
株	株	zhū	/tree trunk/
諸多	諸多	zhūduō	/(used for abstract things) a good deal, a lot of/
逐步	逐步	zhúbù	/progressively/
主導	主導	zhǔdǎo	/leading/
主見	主見	zhǔjiàn	/one's own view/
主力	主力	zhǔlì	/main force/
主流	主流	zhǔliú	/main stream (of a river)/
主權	主權	zhǔquán	/sovereignty/
主人翁	主人翁	zhǔrénwēng	/master (of the house)/
主義	主義	zhǔyì	/-ism/
主宰	主宰	zhǔzǎi	/to dominate/
主旨	主旨	zhǔzhǐ	/gist/
主軸	主軸	zhǔzhóu	/axis/
囑咐	囑咐	zhǔfù	/to tell/
矚目	矚目	zhǔmù	/to focus attention upon/
注定	注定	zhùdìng	/to foreordain/
注目	注目	zhùmù	/attention/
注視	注視	zhùshì	/to watch attentively/
注重	注重	zhùzhòng	/to pay attention to/
住戶	住戶	zhùhù	/household/
住宿	住宿	zhùsù	/to stay at/
柱子	柱子	zhùzi	/pillar/
助教	助教	zhùjiào	/teaching assistant/
助手	助手	zhùshǒu	/assistant/
佇立	佇立	zhùlì	/to stand for a long time/
著作	著作	zhùzuò	/to write/
駐	駐	zhù	/to halt/
抓緊	抓緊	zhuājǐn	/to grasp firmly/
專櫃	專櫃	zhuānguì	/sales counter dedicated to a certain kind of product (e.g. alcohol)/
專員	專員	zhuānyuán	/assistant director/
專制	專制	zhuānzhì	/autocracy/
磚	磚	zhuān	/brick/
轉動	轉動	zhuǎndòng	/to turn sth around/
轉化	轉化	zhuǎnhuà	/to change/
轉手	轉手	zhuǎnshǒu	/to pass on/
轉眼	轉眼	zhuǎnyǎn	/in a flash/
轉移	轉移	zhuǎnyí	/to shift/
轉帳	轉帳	zhuǎnzhàng	//
撰寫	撰寫	zhuànxiě	/to write/
莊嚴	莊嚴	zhuāngyán	/solemn/
裝備	裝備	zhuāngbèi	/equipment/
裝潢	裝潢	zhuānghuáng	/to mount (a picture)/
裝配	裝配	zhuāngpèi	/to assemble/
裝運	裝運	zhuāngyùn	/to ship/
裝置	裝置	zhuāngzhì	/to install/
壯觀	壯觀	zhuàngguān	/spectacular/
壯麗	壯麗	zhuànglì	/magnificence/
狀元	狀元	zhuàngyuán	/top scorer in the palace examination (highest rank of the Imperial examination system)/
追捕	追捕	zhuībǔ	/to pursue/
追查	追查	zhuīchá	/to try to find out/
追究	追究	zhuījiù	/to investigate/
準則	準則	zhǔnzé	/norm/
准許	准許	zhǔnxǔ	/to allow/
卓越	卓越	zhuóyuè	/outstanding/
著手	著手	zhuóshǒu	/to put one's hand to it/
著眼	著眼	zhuóyǎn	/to have one's eyes on (a goal)/
著重	著重	zhuózhòng	/to put emphasis on/
酌量	酌量	zhuóliáng	/to consider/
資深	資深	zīshēn	/veteran (journalist etc)/
資助	資助	zīzhù	/to subsidize/
姿勢	姿勢	zīshì	/posture/
姿態	姿態	zītài	/attitude/
滋味	滋味	zīwèi	/taste/
子彈	子彈	zǐdàn	/bullet/
子弟	子弟	zǐdì	/child/
子孫	子孫	zǐsūn	/offspring/
紫外線	紫外線	zǐwàixiàn	/ultraviolet ray/
自稱	自稱	zìchēng	/to call oneself/
自費	自費	zìfèi	/(be) at one's own expense/
自豪	自豪	zìháo	/proud (of one's achievements etc)/
自覺	自覺	zìjué	/conscious/
自立	自立	zìlì	/independent/
自滿	自滿	zìmǎn	/complacent/
自身	自身	zìshēn	/itself/
自行	自行	zìxíng	/voluntary/
自制	自制	zìzhì	/self-made/
自治	自治	zìzhì	/autonomy/
自傳	自傳	zìzhuàn	/autobiography/
字體	字體	zìtǐ	/calligraphic style/
字眼	字眼	zìyǎn	/wording/
字樣	字樣	zìyàng	/model or template character/
宗旨	宗旨	zōngzhǐ	/objective/
總裁	總裁	zǒngcái	/chairman/
總得	總得	zǒngděi	/must/
總額	總額	zǒngé	/total (amount or value)/
總和	總和	zǒnghé	/sum/
總結	總結	zǒngjié	/to sum up/
總經理	總經理	zǒngjīnglǐ	/general manager/
總數	總數	zǒngshù	/total/
縱火	縱火	zònghuǒ	/to set on fire/
縱容	縱容	zòngróng	/to indulge/
縱使	縱使	zòngshǐ	/even if/
走廊	走廊	zǒuláng	/corridor/
揍	揍	zòu	/to beat up/
租賃	租賃	zūlìn	/to rent/
足夠	足夠	zúgòu	/enough/
祖宗	祖宗	zǔzōng	/ancestor/
阻擋	阻擋	zǔdǎng	/to stop/
阻力	阻力	zǔlì	/resistance/
阻撓	阻撓	zǔnáo	/to thwart/
阻塞	阻塞	zǔsè	/to block/
組裝	組裝	zǔzhuāng	/to assemble and install/
鑽研	鑽研	zuānyán	/to study meticulously/
嘴脣	嘴脣	zuǐchún	//
罪惡	罪惡	zuìè	/crime/
罪名	罪名	zuìmíng	/criminal charge/
罪行	罪行	zuìxìng	/crime/
尊嚴	尊嚴	zūnyán	/dignity/
遵循	遵循	zūnxún	/to follow/
作風	作風	zuòfēng	/style/
作怪	作怪	zuòguài	/(of a ghost) to make strange things happen/
作物	作物	zuòwù	/crop/
作戰	作戰	zuòzhàn	/combat/
作證	作證	zuòzhèng	/to bear witness/
坐牢	坐牢	zuòláo	/to be imprisoned/
坐鎮	坐鎮	zuòzhèn	/(of a commanding officer) to keep watch/
座談	座談	zuòtán	/to have an informal discussion/
座右銘	座右銘	zuòyòumíng	/motto/
