男	男	nán	/male/
女	女	nǚ	/female/
孩子	孩子	háizi	/child/
小姐	小姐	xiǎojiě	/young lady/
先生	先生	xiānshēng	/Mister (Mr.)/
太太	太太	tàitai	/married woman/
女兒	女兒	nǚér	/daughter/
兒子	兒子	érzi	/son/
大家	大家	dàjiā	/everyone/
路	路	lù	/road/
手機	手機	shǒujī	/cell phone/
號碼	號碼	hàomǎ	/number/
明年	明年	míngnián	/next year/
去年	去年	qùnián	/last year/
生日	生日	shēngrì	/birthday/
月	月	yuè	/moon/
星期	星期	xīngqí	/week/
星期天	星期天	xīngqítiān	/Sunday/
週末	週末	zhōumò	/weekend/
從	從	cóng	/from/
笑	笑	xiào	/laugh/
愛	愛	ài	/to love/
好看	好看	hǎokàn	/good-looking/
快樂	快樂	kuàilè	/happy/
非常	非常	fēicháng	/very/
工作	工作	gōngzuò	/to work/
醫生	醫生	yīshēng	/doctor/
醫院	醫院	yīyuàn	/hospital/
公司	公司	gōngsī	/(business) company/
賣	賣	mài	/to sell/
準備	準備	zhǔnbèi	/preparation/
一點	一點	yīdiǎn	/a bit/
一些	一些	yīxiē	/some/
張	張	zhāng	/to open up/
中學	中學	zhōngxué	/middle school/
年級	年級	niánjí	/grade/
英文	英文	yīngwén	/English (language)/
紙	紙	zhǐ	/paper/
問題	問題	wèntí	/question/
意思	意思	yìsi	/idea/
圖書館	圖書館	túshūguǎn	/library/
數學	數學	shùxué	/mathematics/
歷史	歷史	lìshǐ	/history/
餐廳	餐廳	cāntīng	/dining hall/
學習	學習	xuéxí	/to learn/
參加	參加	cānjiā	/to participate/
畫	畫	huà	/to draw/
讀	讀	dú	/comma/
會	會	huì	/can/
有趣	有趣	yǒuqù	/interesting/
為什麼	為什麼	wèishénme	/why?/
下課	下課	xiàkè	/to finish class/
說話	說話	shuōhuà	/to speak/
考試	考試	kǎoshì	/to take an exam/
懂	懂	dǒng	/to understand/
天氣	天氣	tiānqì	/weather/
房子	房子	fángzi	/house/
門	門	mén	/gate/
山	山	shān	/mountain/
客廳	客廳	kètīng	/drawing room (room for arriving guests)/
河	河	hé	/river/
狗	狗	gǒu	/dog/
花	花	huā	/flower/
風	風	fēng	/wind/
海	海	hǎi	/ocean/
魚	魚	yú	/fish/
樹	樹	shù	/tree/
冷	冷	lěng	/cold/
熱	熱	rè	/to warm up/
洗澡	洗澡	xǐzǎo	/to bathe/
咖啡	咖啡	kāfēi	/coffee (loanword)/
茶	茶	chá	/tea/
生活	生活	shēnghuó	/life/
用	用	yòng	/to use/
穿	穿	chuān	/to wear/
起床	起床	qǐchuáng	/to get out of bed/
方便	方便	fāngbiàn	/convenient/
睡覺	睡覺	shuìjiào	/to go to bed/
常常	常常	chángcháng	/frequently/
每	每	měi	/each/
次	次	cì	/next in sequence/
音樂	音樂	yīnyuè	/music/
票	票	piào	/ticket/
照片	照片	zhàopiàn	/photograph/
玩	玩	wán	/Taiwan pr. [wan4]/
跑	跑	pǎo	/(of an animal) to paw (the ground)/
運動	運動	yùndòng	/to move/
開始	開始	kāishǐ	/to begin/
走路	走路	zǒulù	/to walk/
唱歌	唱歌	chànggē	/to sing a song/
信	信	xìn	/letter/
喂	喂	wéi	/to feed/
介紹	介紹	jièshào	/to introduce (sb to sb)/
換	換	huàn	/to exchange/
認識	認識	rènshi	/to know/
沒關係	沒關係	méiguānxi	/it doesn't matter/
怎麼	怎麼	zěnme	/how?/
哪	哪	nǎ	/how/
哪裡	哪裡	nǎlǐ	/where?/
這裡	這裡	zhèlǐ	/here/
那裡	那裡	nàlǐ	/there/
外	外	wài	/outside/
右邊	右邊	yòubiān	/right side/
左邊	左邊	zuǒbiān	/left/
旁邊	旁邊	pángbiān	/lateral/
中間	中間	zhōngjiān	/between/
地鐵	地鐵	dìtiě	/subway/
地方	地方	dìfāng	/region/
附近	附近	fùjìn	/(in the) vicinity/
離	離	lí	/to leave/
往	往	wǎng	/old variant of 往[wang3]/
送	送	sòng	/to deliver/
帶	帶	dài	/band/
放	放	fàng	/to put/
拿	拿	ná	/to hold/
進來	進來	jìnlái	/to come in/
出去	出去	chūqù	/to go out/
站	站	zhàn	/station/
慢	慢	màn	/slow/
遠	遠	yuǎn	/far/
身體	身體	shēntǐ	/the body/
眼睛	眼睛	yǎnjīng	/eye/
藥	藥	yào	/medicine/
累	累	lèi	/rope/
雙	雙	shuāng	/two/
元	元	yuán	/the Yuan or Mongol dynasty (1279-1368)/
鞋子	鞋子	xiézi	/shoe/
褲子	褲子	kùzi	/trousers/
市場	市場	shìchǎng	/marketplace/
衣服	衣服	yīfu	/clothes/
比	比	bǐ	/Belgium/
要	要	yào	/to demand/
長	長	cháng	/length/
新	新	xīn	/new/
一樣	一樣	yīyàng	/same/
好吃	好吃	hǎochī	/tasty/
件	件	jiàn	/item/
杯	杯	bēi	/trophy cup/
瓶	瓶	píng	/variant of 瓶[ping2]/
菜	菜	cài	/dish (type of food)/
蘋果	蘋果	píngguǒ	/apple/
肉	肉	ròu	/meat/
酒	酒	jiǔ	/wine (esp. rice wine)/
喝	喝	hē	/to drink/
一起	一起	yīqǐ	/in the same place/
因為	因為	yīnwèi	/because/
和	和	hé	/harmonious/
所以	所以	suǒyǐ	/therefore/
跟	跟	gēn	/heel/
著	著	zhe	/(chess) move/
可能	可能	kěnéng	/might (happen)/
